SUMLEV,Geo,CED_V0,CED_V1,CED_V2,CED_V3
SL010,34,46722980,22896602,23826378,96.0977031422904
SL030,3401,8384408,4133898,4250510,97.2565174531997
SL030,3402,1308728,645498,663230,97.3264176831567
SL030,3403,1028244,490738,537506,91.2990738708033
SL030,3404,1128908,561803,567105,99.0650761322859
SL030,3405,2127685,1054032,1073653,98.1725007986752
SL030,3406,580229,281564,298665,94.2741867979174
SL030,3407,2409164,1186363,1222801,97.0201201994437
SL030,3408,2026807,1014199,1012608,100.157119043105
SL030,3409,7600065,3730326,3869739,96.3973539300712
SL030,3410,4963703,2446383,2517320,97.1820428074301
SL030,3411,1072863,531255,541608,98.0884698896619
SL030,3412,2701743,1300609,1401134,92.8254542392091
SL030,3413,6578079,3147872,3430207,91.7691556223866
SL030,3414,1478509,740143,738366,100.240666552902
SL030,3415,647554,320469,327085,97.9772841921825
SL030,3416,2199088,1068750,1130338,94.5513642821882
SL030,3417,315675,155758,159917,97.3992758743598
SL030,3418,85144,43177,41967,102.88321776634
SL030,3419,86384,43765,42619,102.68894155189
SL040,340104,709340,361319,348021,103.821033788191
SL040,340111,1238714,611357,627357,97.4496180005961
SL040,340114,785240,385085,400155,96.2339593407555
SL040,340118,912075,449318,462757,97.0958840168814
SL040,340121,519932,257713,262219,98.2815890534248
SL040,340123,638099,315549,322550,97.8294838009611
SL040,340129,1641121,804858,836263,96.244602475537
SL040,340141,1939887,948699,991188,95.7133258271892
SL040,340222,219345,110599,108746,101.703970720762
SL040,340244,134572,68060,66512,102.327399566995
SL040,340250,954811,466839,487972,95.6692187256646
SL040,340333,1028244,490738,537506,91.2990738708033
SL040,340407,1128908,561803,567105,99.0650761322859
SL040,340535,1109175,552555,556620,99.2696992562251
SL040,340538,1018510,501477,517033,96.9912945595349
SL040,340639,580229,281564,298665,94.2741867979174
SL040,340705,158498,79538,78960,100.73201621074
SL040,340709,357070,178337,178733,99.7784404670654
SL040,340724,463746,225646,238100,94.7694246115078
SL040,340734,162035,80323,81712,98.3001272762875
SL040,340737,331473,161065,170408,94.5172761842167
SL040,340740,153342,76979,76363,100.806673388945
SL040,340742,88600,44800,43800,102.283105022831
SL040,340747,519851,253356,266495,95.0697011200961
SL040,340749,174549,86319,88230,97.8340700442026
SL040,340802,388786,194158,194628,99.7585136773743
SL040,340813,499100,246656,252444,97.7072142732646
SL040,340816,197222,98999,98223,100.790038992904
SL040,340819,254308,128854,125454,102.710156710826
SL040,340845,687391,345532,341859,101.074419570642
SL040,340908,5609350,2733466,2875884,95.0478531122952
SL040,340917,761947,380690,381257,99.8512814190953
SL040,340925,432866,219509,213357,102.883430119471
SL040,340943,795902,396661,399241,99.3537737857585
SL040,341003,1838819,911097,927722,98.2079760962875
SL040,341012,576898,286359,290539,98.5612946970975
SL040,341046,2547986,1248927,1299059,96.1408989122126
SL040,341106,676376,334636,341740,97.9212266635454
SL040,341110,396487,196619,199868,98.3744271219005
SL040,341215,1119351,536637,582714,92.0926904107332
SL040,341227,331327,160647,170680,94.121748300914
SL040,341232,309293,148426,160867,92.2662820839575
SL040,341236,941772,454899,486873,93.4327843195248
SL040,341328,6578079,3147872,3430207,91.7691556223866
SL040,341430,1478509,740143,738366,100.240666552902
SL040,341531,647554,320469,327085,97.9772841921825
SL040,341601,328868,162175,166693,97.2896282387383
SL040,341620,720592,351696,368896,95.337439278279
SL040,341648,1149628,554879,594749,93.2963317298558
SL040,341726,315675,155758,159917,97.3992758743598
SL040,341851,85144,43177,41967,102.88321776634
SL040,341952,86384,43765,42619,102.68894155189
SL050,34160101001,2887,1507,1380,109.202898550725
SL050,34160101002,10286,5075,5211,97.3901362502399
SL050,34160101003,1483,774,709,109.16784203103
SL050,34160101004,1831,912,919,99.2383025027203
SL050,34160101006,219,115,104,110.576923076923
SL050,34160101008,982,535,447,119.686800894855
SL050,34160101009,1643,833,810,102.83950617284
SL050,34160101010,2967,1503,1464,102.66393442623
SL050,34160101011,286,159,127,125.196850393701
SL050,34160101013,883,493,390,126.410256410256
SL050,34160101014,443,238,205,116.09756097561
SL050,34160101016,511,303,208,145.673076923077
SL050,34160101017,1040,548,492,111.382113821138
SL050,34160101018,1753,952,801,118.851435705368
SL050,34160101019,181,96,85,112.941176470588
SL050,34160101020,381,222,159,139.622641509434
SL050,34160101021,603,316,287,110.104529616725
SL050,34160101022,1025,513,512,100.1953125
SL050,34160101023,348,170,178,95.5056179775281
SL050,34160101027,517,281,236,119.067796610169
SL050,34160101028,1445,759,686,110.64139941691
SL050,34160101030,158,88,70,125.714285714286
SL050,34160101031,1505,776,729,106.447187928669
SL050,34160101032,667,341,326,104.601226993865
SL050,34160101033,857,441,416,106.009615384615
SL050,34160101034,196,100,96,104.166666666667
SL050,34160101036,18205,8979,9226,97.3227834381097
SL050,34160101037,717,399,318,125.471698113208
SL050,34160101039,229,113,116,97.4137931034483
SL050,34160101041,209,117,92,127.173913043478
SL050,34160101042,1162,601,561,107.130124777184
SL050,34160101043,3368,1718,1650,104.121212121212
SL050,34160101044,257,152,105,144.761904761905
SL050,34160101046,780,447,333,134.234234234234
SL050,34160101047,1374,745,629,118.441971383148
SL050,34160101049,151,87,64,135.9375
SL050,34160101051,5018,2497,2521,99.0479968266561
SL050,34160101052,319,155,164,94.5121951219512
SL050,34160101053,709,390,319,122.257053291536
SL050,34160101054,1336,688,648,106.172839506173
SL050,34160101055,991,546,445,122.696629213483
SL050,34160101056,229,129,100,129
SL050,34160101057,299,150,149,100.671140939597
SL050,34160101058,1869,992,877,113.112884834664
SL050,34160101059,249176,121358,127818,94.9459387566696
SL050,34160101060,269,139,130,106.923076923077
SL050,34160101061,186,104,82,126.829268292683
SL050,34160101062,400,214,186,115.05376344086
SL050,34160101063,2313,1193,1120,106.517857142857
SL050,34160101901,3333,1721,1612,106.761786600496
SL050,34160101902,872,491,381,128.871391076115
SL050,34080202001,757,363,394,92.1319796954315
SL050,34080202002,529,300,229,131.004366812227
SL050,34080202003,173050,84613,88437,95.6760179562853
SL050,34080202004,693,357,336,106.25
SL050,34080202005,650,339,311,109.003215434084
SL050,34080202006,655,356,299,119.063545150502
SL050,34080202007,1199,639,560,114.107142857143
SL050,34080202008,1405,724,681,106.314243759178
SL050,34080202009,24537,12215,12322,99.1316344749229
SL050,34080202010,2275,1183,1092,108.333333333333
SL050,34080202011,638,341,297,114.814814814815
SL050,34080202012,2360,1205,1155,104.329004329004
SL050,34080202013,150,85,65,130.769230769231
SL050,34080202014,409,208,201,103.482587064677
SL050,34080202015,1864,941,923,101.950162513543
SL050,34080202016,610,326,284,114.788732394366
SL050,34080202017,873,462,411,112.408759124088
SL050,34080202018,1057,538,519,103.660886319846
SL050,34080202019,2837,1447,1390,104.10071942446
SL050,34080202020,508,279,229,121.834061135371
SL050,34080202021,1275,669,606,110.39603960396
SL050,34080202022,344,194,150,129.333333333333
SL050,34080202023,588,311,277,112.274368231047
SL050,34080202024,4522,2291,2231,102.689376961004
SL050,34080202025,10003,5089,4914,103.561253561254
SL050,34080202026,1182,601,581,103.442340791738
SL050,34080202027,330,177,153,115.686274509804
SL050,34080202028,128,64,64,100
SL050,34080202029,4182,2183,1999,109.204602301151
SL050,34080202030,3624,1819,1805,100.775623268698
SL050,34080202031,674,327,347,94.2363112391931
SL050,34080202032,297,168,129,130.232558139535
SL050,34080202033,2489,1303,1186,109.865092748735
SL050,34080202034,1816,912,904,100.884955752212
SL050,34080202035,2448,1259,1189,105.887300252313
SL050,34080202036,110,58,52,111.538461538462
SL050,34080202037,30268,15124,15144,99.8679344955098
SL050,34080202038,349,181,168,107.738095238095
SL050,34080202039,1184,610,574,106.271777003484
SL050,34080202040,621,332,289,114.878892733564
SL050,34080202041,360,195,165,118.181818181818
SL050,34080202042,928,448,480,93.3333333333333
SL050,34080202043,1398,721,677,106.499261447563
SL050,34080202044,1200,626,574,109.059233449477
SL050,34080202045,4665,2387,2278,104.784899034241
SL050,34080202046,1359,698,661,105.597579425113
SL050,34080202047,113,62,51,121.56862745098
SL050,34080202048,1537,799,738,108.265582655827
SL050,34080202049,840,435,405,107.407407407407
SL050,34080202050,96,53,43,123.255813953488
SL050,34080202051,2042,1036,1006,102.982107355865
SL050,34080202052,548,292,256,114.0625
SL050,34080202053,3513,1793,1720,104.244186046512
SL050,34080202054,518,271,247,109.716599190283
SL050,34080202055,1222,676,546,123.809523809524
SL050,34080202056,2028,1022,1006,101.590457256461
SL050,34080202057,2352,1169,1183,98.8165680473373
SL050,34080202058,360,194,166,116.867469879518
SL050,34080202059,331,181,150,120.666666666667
SL050,34080202060,1420,832,588,141.496598639456
SL050,34080202061,696,359,337,106.528189910979
SL050,34080202062,446,247,199,124.120603015075
SL050,34080202063,1635,853,782,109.079283887468
SL050,34080202064,401,205,196,104.591836734694
SL050,34080202065,489,258,231,111.688311688312
SL050,34080202066,254,133,121,109.917355371901
SL050,34080202067,1357,696,661,105.295007564297
SL050,34080202068,363,200,163,122.699386503067
SL050,34080202069,15515,7835,7680,102.018229166667
SL050,34080202070,501,265,236,112.28813559322
SL050,34080202071,1153,587,566,103.710247349823
SL050,34080202072,1790,920,870,105.747126436782
SL050,34080202073,6255,3198,3057,104.612365063788
SL050,34080202074,7738,3955,3783,104.546656093048
SL050,34080202075,1943,1004,939,106.92225772098
SL050,34080202076,355,179,176,101.704545454545
SL050,34080202077,57,34,23,147.826086956522
SL050,34080202078,1115,585,530,110.377358490566
SL050,34080202079,4112,2077,2035,102.063882063882
SL050,34080202080,589,307,282,108.86524822695
SL050,34080202081,25241,12463,12778,97.534825481296
SL050,34080202082,95,58,37,156.756756756757
SL050,34080202083,226,137,89,153.932584269663
SL050,34080202084,340,174,166,104.819277108434
SL050,34080202085,340,174,166,104.819277108434
SL050,34080202086,2674,1371,1303,105.218726016884
SL050,34080202901,2786,1401,1385,101.15523465704
SL050,34100303001,661,346,315,109.84126984127
SL050,34100303002,4713,2344,2369,98.9447024060785
SL050,34100303003,551,294,257,114.396887159533
SL050,34100303004,936,493,443,111.286681715576
SL050,34100303005,12042,6172,5870,105.144804088586
SL050,34100303006,1298,645,653,98.7748851454824
SL050,34100303007,229,115,114,100.877192982456
SL050,34100303008,180,94,86,109.302325581395
SL050,34100303009,58977,28806,30171,95.4757880083524
SL050,34100303010,407,198,209,94.7368421052632
SL050,34100303011,20053,9947,10106,98.4266772214526
SL050,34100303012,2838,1427,1411,101.133947554926
SL050,34100303013,1341,671,670,100.149253731343
SL050,34100303014,331577,160595,170982,93.9250915301026
SL050,34100303015,20542,10398,10144,102.503943217666
SL050,34100303016,104,54,50,108
SL050,34100303017,491,237,254,93.3070866141732
SL050,34100303018,21995,10756,11239,95.7024646320847
SL050,34100303019,20537,10324,10213,101.086850093019
SL050,34100303020,122,65,57,114.035087719298
SL050,34100303021,7113,3562,3551,100.309771895241
SL050,34100303022,156,77,79,97.4683544303797
SL050,34100303023,1703,866,837,103.464755077658
SL050,34100303024,5361,2689,2672,100.63622754491
SL050,34100303025,1940,1011,929,108.826695371367
SL050,34100303026,1983,1005,978,102.760736196319
SL050,34100303027,178,89,89,100
SL050,34100303028,1118,566,552,102.536231884058
SL050,34100303029,444,228,216,105.555555555556
SL050,34100303030,1110,556,554,100.361010830325
SL050,34100303031,67558,33581,33977,98.834505695029
SL050,34100303032,108,59,49,120.408163265306
SL050,34100303033,149,74,75,98.6666666666667
SL050,34100303034,3357,1634,1723,94.8345908299478
SL050,34100303035,742,384,358,107.262569832402
SL050,34100303036,94,43,51,84.3137254901961
SL050,34100303037,490,241,249,96.7871485943775
SL050,34100303038,413,205,208,98.5576923076923
SL050,34100303039,96,55,41,134.146341463415
SL050,34100303040,410,190,220,86.3636363636364
SL050,34100303041,10768,5264,5504,95.6395348837209
SL050,34100303042,4130,2039,2091,97.5131516021043
SL050,34100303043,3651,1792,1859,96.3959117805272
SL050,34100303044,6702,3380,3322,101.745936183022
SL050,34100303045,418,221,197,112.182741116751
SL050,34100303046,2925,1498,1427,104.975473020322
SL050,34100303047,21633,10900,10733,101.555948942514
SL050,34100303048,7257,3708,3549,104.480135249366
SL050,34100303049,18864,9602,9262,103.670913409631
SL050,34100303050,27893,13565,14328,94.6747627024009
SL050,34100303051,428,218,210,103.809523809524
SL050,34100303052,1214,609,605,100.661157024793
SL050,34100303053,9880,5016,4864,103.125
SL050,34100303054,435,223,212,105.188679245283
SL050,34100303055,8631,4319,4312,100.162337662338
SL050,34100303056,11456,5822,5634,103.336883209088
SL050,34100303057,208,118,90,131.111111111111
SL050,34100303058,7226,3698,3528,104.818594104308
SL050,34100303059,28957,14640,14317,102.256059230286
SL050,34100303060,121,68,53,128.301886792453
SL050,34100303061,1718,850,868,97.926267281106
SL050,34100303062,685,356,329,108.206686930091
SL050,34100303063,41733,20245,21488,94.2153760238272
SL050,34100303064,7383,3689,3694,99.8646453708717
SL050,34100303065,230625,114332,116293,98.3137420137068
SL050,34100303066,52404,25549,26855,95.1368460249488
SL050,34100303067,101,52,49,106.122448979592
SL050,34100303068,53,29,24,120.833333333333
SL050,34100303069,6381,3231,3150,102.571428571429
SL050,34100303070,4131,2069,2062,100.339476236663
SL050,34100303071,5893,2974,2919,101.884206920178
SL050,34100303072,471,241,230,104.782608695652
SL050,34100303073,258,144,114,126.315789473684
SL050,34100303074,2489,1310,1179,111.111111111111
SL050,34100303075,209,104,105,99.0476190476191
SL050,34100303076,15058,7358,7700,95.5584415584416
SL050,34100303077,2474,1256,1218,103.11986863711
SL050,34100303078,1132,585,547,106.946983546618
SL050,34100303079,23403,11720,11683,100.316699477874
SL050,34100303080,1986,1009,977,103.275332650972
SL050,34100303081,2683,1338,1345,99.4795539033457
SL050,34100303082,27224,13528,13696,98.7733644859813
SL050,34100303083,6875,3342,3533,94.5938296065667
SL050,34100303084,596,293,303,96.6996699669967
SL050,34100303085,1051,529,522,101.340996168582
SL050,34100303086,229,122,107,114.018691588785
SL050,34100303088,7944,4172,3772,110.604453870626
SL050,34100303089,12175,6077,6098,99.6556247950148
SL050,34100303090,25009,12458,12551,99.2590231854035
SL050,34100303091,493,233,260,89.6153846153846
SL050,34100303092,9328,4627,4701,98.4258668368432
SL050,34100303093,25725,12803,12922,99.0790899241603
SL050,34100303094,18242,9205,9037,101.859024012393
SL050,34100303095,6815,3418,3397,100.618192522814
SL050,34100303096,7475,3734,3741,99.8128842555466
SL050,34100303097,2111,1036,1075,96.3720930232558
SL050,34100303098,738,373,365,102.191780821918
SL050,34100303099,76778,38144,38634,98.7316871149765
SL050,34100303100,908,443,465,95.2688172043011
SL050,34100303101,7490,3717,3773,98.5157699443414
SL050,34100303102,10052,5036,5016,100.398724082935
SL050,34100303103,301,158,143,110.48951048951
SL050,34100303104,34479,17121,17358,98.6346353266505
SL050,34100303105,7845,3962,3883,102.034509399948
SL050,34100303106,713,387,326,118.711656441718
SL050,34100303107,4850,2499,2351,106.295193534666
SL050,34100303109,4418,2207,2211,99.8190863862506
SL050,34100303110,644,328,316,103.79746835443
SL050,34100303111,7797,4007,3790,105.725593667546
SL050,34100303112,1147,589,558,105.555555555556
SL050,34100303113,16560,8393,8167,102.767233990449
SL050,34100303114,2376,1230,1146,107.329842931937
SL050,34100303115,389,193,196,98.469387755102
SL050,34100303116,1585,813,772,105.310880829016
SL050,34100303117,648,331,317,104.416403785489
SL050,34100303118,7943,4030,3913,102.990033222591
SL050,34100303119,23518,11376,12142,93.6913193872509
SL050,34100303120,5811,2949,2862,103.039832285115
SL050,34100303121,31745,15916,15829,100.549624107651
SL050,34100303122,57785,28588,29197,97.9141692639655
SL050,34100303123,9771,4920,4851,101.422387136673
SL050,34100303124,585,308,277,111.191335740072
SL050,34100303125,581,303,278,108.992805755396
SL050,34100303127,627,324,303,106.930693069307
SL050,34100303128,10722,5331,5391,98.8870339454647
SL050,34100303129,1564,824,740,111.351351351351
SL050,34100303130,56,30,26,115.384615384615
SL050,34100303131,336,164,172,95.3488372093023
SL050,34100303132,654,348,306,113.725490196078
SL050,34100303133,82599,41038,41561,98.7416087197132
SL050,34100303134,164,90,74,121.621621621622
SL050,34100303135,224,117,107,109.345794392523
SL050,34100303136,589,319,270,118.148148148148
SL050,34100303137,820,407,413,98.547215496368
SL050,34100303138,4520,2247,2273,98.8561372635284
SL050,34100303139,33969,16949,17020,99.5828437132785
SL050,34100303140,33983,16992,16991,100.005885468778
SL050,34100303901,2864,1360,1504,90.4255319148936
SL050,34100303902,21418,10981,10437,105.212225735365
SL050,34100303903,4844,2453,2391,102.593057298202
SL050,34100303904,1933,988,945,104.550264550265
SL050,34010404001,1235,633,602,105.14950166113
SL050,34010404002,1150,600,550,109.090909090909
SL050,34010404003,24859,12639,12220,103.428805237316
SL050,34010404004,753,384,369,104.065040650407
SL050,34010404005,621,307,314,97.7707006369427
SL050,34010404006,11696,6023,5673,106.16957518068
SL050,34010404007,814,417,397,105.037783375315
SL050,34010404008,528,288,240,120
SL050,34010404009,135,59,76,77.6315789473684
SL050,34010404010,648,340,308,110.38961038961
SL050,34010404011,3615,1811,1804,100.388026607539
SL050,34010404012,212,111,101,109.90099009901
SL050,34010404013,196851,95953,100898,95.0990108822772
SL050,34010404014,176,91,85,107.058823529412
SL050,34010404015,133,79,54,146.296296296296
SL050,34010404016,3169,1595,1574,101.33418043202
SL050,34010404017,4586,2311,2275,101.582417582418
SL050,34010404018,321,157,164,95.7317073170732
SL050,34010404019,232,124,108,114.814814814815
SL050,34010404020,284,150,134,111.940298507463
SL050,34010404021,206,101,105,96.1904761904762
SL050,34010404022,927,463,464,99.7844827586207
SL050,34010404023,117,58,59,98.3050847457627
SL050,34010404024,4357,2157,2200,98.0454545454545
SL050,34010404026,68,39,29,134.48275862069
SL050,34010404027,248,130,118,110.169491525424
SL050,34010404028,243,140,103,135.922330097087
SL050,34010404029,12381,6267,6114,102.502453385672
SL050,34010404030,1202,629,573,109.77312390925
SL050,34010404031,3228,1630,1598,102.002503128911
SL050,34010404032,7757,3977,3780,105.21164021164
SL050,34010404033,121,59,62,95.1612903225806
SL050,34010404034,143,83,60,138.333333333333
SL050,34010404035,13776,7168,6608,108.474576271186
SL050,34010404036,283,143,140,102.142857142857
SL050,34010404037,1525,762,763,99.8689384010485
SL050,34010404038,4031,1987,2044,97.2113502935421
SL050,34010404041,418,236,182,129.67032967033
SL050,34010404043,642,363,279,130.10752688172
SL050,34010404044,1992,1046,946,110.570824524313
SL050,34010404045,1992,1005,987,101.823708206687
SL050,34010404046,975,512,463,110.583153347732
SL050,34010404047,3027,1575,1452,108.471074380165
SL050,34010404048,2803,1417,1386,102.236652236652
SL050,34010404049,8838,4562,4276,106.688493919551
SL050,34010404050,1031,553,478,115.690376569038
SL050,34010404051,486,236,250,94.4
SL050,34010404052,17418,8869,8549,103.743127851211
SL050,34010404053,18816,9359,9457,98.9637305699482
SL050,34010404054,390,212,178,119.101123595506
SL050,34010404055,429,213,216,98.6111111111111
SL050,34010404056,169,99,70,141.428571428571
SL050,34010404057,1538,767,771,99.4811932555123
SL050,34010404058,390,205,185,110.810810810811
SL050,34010404059,1431,700,731,95.7592339261286
SL050,34010404060,546,299,247,121.052631578947
SL050,34010404061,766,377,389,96.9151670951157
SL050,34010404062,5539,2843,2696,105.452522255193
SL050,34010404063,1261,649,612,106.045751633987
SL050,34010404064,6301,3085,3216,95.9266169154229
SL050,34010404065,460,231,229,100.873362445415
SL050,34010404066,30122,16618,13504,123.059834123223
SL050,34010404067,596,299,297,100.673400673401
SL050,34010404068,180,100,80,125
SL050,34010404069,6212,3194,3018,105.831676607025
SL050,34010404070,2238,1172,1066,109.943714821764
SL050,34010404071,419,216,203,106.4039408867
SL050,34010404072,1055,530,525,100.952380952381
SL050,34010404073,362,212,150,141.333333333333
SL050,34010404074,4018,2038,1980,102.929292929293
SL050,34010404075,9502,4966,4536,109.479717813051
SL050,34010404076,1621,851,770,110.519480519481
SL050,34010404077,304,163,141,115.602836879433
SL050,34010404078,1364,690,674,102.373887240356
SL050,34010404079,94925,49038,45887,106.866868612025
SL050,34010404080,218,107,111,96.3963963963964
SL050,34010404081,432,219,213,102.816901408451
SL050,34010404082,300,157,143,109.79020979021
SL050,34010404083,2035,1035,1000,103.5
SL050,34010404084,393,206,187,110.160427807487
SL050,34010404085,463,234,229,102.183406113537
SL050,34010404086,2389,1254,1135,110.484581497797
SL050,34010404087,217,120,97,123.711340206186
SL050,34010404088,3704,1916,1788,107.158836689038
SL050,34010404089,963,463,500,92.6
SL050,34010404090,324,159,165,96.3636363636364
SL050,34010404091,381,192,189,101.587301587302
SL050,34010404092,3569,1769,1800,98.2777777777778
SL050,34010404093,3384,1734,1650,105.090909090909
SL050,34010404094,233,136,97,140.20618556701
SL050,34010404095,836,415,421,98.5748218527316
SL050,34010404096,329,172,157,109.554140127389
SL050,34010404097,253,137,116,118.103448275862
SL050,34010404098,1938,995,943,105.514316012725
SL050,34010404099,6630,3231,3399,95.0573698146514
SL050,34010404100,15837,8052,7785,103.429672447013
SL050,34010404101,5791,2939,2852,103.05049088359
SL050,34010404102,25405,13547,11858,114.243548659133
SL050,34010404103,2893,1441,1452,99.2424242424242
SL050,34010404901,570,307,263,116.730038022814
SL050,34010404902,84710,44462,40248,110.470085470085
SL050,34010404903,9003,5027,3976,126.433601609658
SL050,34010404904,2933,1528,1405,108.754448398577
SL050,34070505001,202,113,89,126.966292134831
SL050,34070505002,2517,1298,1219,106.480721903199
SL050,34070505005,190,100,90,111.111111111111
SL050,34070505007,119,63,56,112.5
SL050,34070505008,233,115,118,97.4576271186441
SL050,34070505010,168,85,83,102.409638554217
SL050,34070505012,135,69,66,104.545454545455
SL050,34070505013,972,495,477,103.77358490566
SL050,34070505014,6454,3135,3319,94.456161494426
SL050,34070505015,75,35,40,87.5
SL050,34070505016,8069,3919,4150,94.433734939759
SL050,34070505017,86,49,37,132.432432432432
SL050,34070505018,26,15,11,136.363636363636
SL050,34070505019,57657,27472,30185,91.0120920987245
SL050,34070505021,2368,1145,1223,93.6222403924775
SL050,34070505022,1889,976,913,106.900328587076
SL050,34070505023,186,103,83,124.096385542169
SL050,34070505024,206,108,98,110.204081632653
SL050,34070505025,90,50,40,125
SL050,34070505026,199,106,93,113.978494623656
SL050,34070505027,323,164,159,103.14465408805
SL050,34070505029,108,64,44,145.454545454545
SL050,34070505030,43,22,21,104.761904761905
SL050,34070505033,193,102,91,112.087912087912
SL050,34070505034,16,8,8,100
SL050,34070505035,114,57,57,100
SL050,34070505036,126,62,64,96.875
SL050,34070505037,248,142,106,133.962264150943
SL050,34070505038,120,71,49,144.897959183673
SL050,34070505039,44,27,17,158.823529411765
SL050,34070505040,65,43,22,195.454545454545
SL050,34070505041,1196,621,575,108
SL050,34070505042,157,77,80,96.25
SL050,34070505043,84,44,40,110
SL050,34070505044,275,150,125,120
SL050,34070505045,82,43,39,110.25641025641
SL050,34070505046,48,26,22,118.181818181818
SL050,34070505047,4998,2528,2470,102.348178137652
SL050,34070505048,112,63,49,128.571428571429
SL050,34070505049,452,239,213,112.206572769953
SL050,34070505051,181,98,83,118.072289156627
SL050,34070505052,92,48,44,109.090909090909
SL050,34070505053,84,46,38,121.052631578947
SL050,34070505054,1429,742,687,108.005822416303
SL050,34070505055,637,338,299,113.04347826087
SL050,34070505056,95,53,42,126.190476190476
SL050,34070505057,3056,1576,1480,106.486486486486
SL050,34070505058,76,43,33,130.30303030303
SL050,34070505059,100,60,40,150
SL050,34070505060,109,56,53,105.660377358491
SL050,34070505061,329,172,157,109.554140127389
SL050,34070505062,179,92,87,105.747126436782
SL050,34070505063,32,20,12,166.666666666667
SL050,34070505064,106,60,46,130.434782608696
SL050,34070505065,496,264,232,113.793103448276
SL050,34070505066,491,271,220,123.181818181818
SL050,34070505067,79,47,32,146.875
SL050,34070505069,79,45,34,132.352941176471
SL050,34070505070,33,17,16,106.25
SL050,34070505072,106,57,49,116.326530612245
SL050,34070505073,307,168,139,120.863309352518
SL050,34070505074,751,391,360,108.611111111111
SL050,34070505075,121,56,65,86.1538461538462
SL050,34070505076,601,312,289,107.958477508651
SL050,34070505077,165,88,77,114.285714285714
SL050,34070505078,105,59,46,128.260869565217
SL050,34070505079,63,37,26,142.307692307692
SL050,34070505080,43,21,22,95.4545454545455
SL050,34070505081,40,28,12,233.333333333333
SL050,34070505082,587,317,270,117.407407407407
SL050,34070505083,155,82,73,112.328767123288
SL050,34070505084,68,40,28,142.857142857143
SL050,34070505085,36,17,19,89.4736842105263
SL050,34070505086,77,48,29,165.51724137931
SL050,34070505087,161,54,107,50.4672897196262
SL050,34070505088,31,15,16,93.75
SL050,34070505089,511,252,259,97.2972972972973
SL050,34070505090,78,38,40,95
SL050,34070505092,169,94,75,125.333333333333
SL050,34070505093,405,230,175,131.428571428571
SL050,34070505094,135,74,61,121.311475409836
SL050,34070505095,267,148,119,124.36974789916
SL050,34070505096,78,47,31,151.612903225806
SL050,34070505097,518,274,244,112.295081967213
SL050,34070505099,512,287,225,127.555555555556
SL050,34070505100,295,155,140,110.714285714286
SL050,34070505101,290,167,123,135.772357723577
SL050,34070505102,2164,1123,1041,107.877041306436
SL050,34070505103,67,34,33,103.030303030303
SL050,34070505104,34,20,14,142.857142857143
SL050,34070505105,363,197,166,118.674698795181
SL050,34070505106,29,15,14,107.142857142857
SL050,34070505107,54,33,21,157.142857142857
SL050,34070505108,40,21,19,110.526315789474
SL050,34070505109,487,255,232,109.913793103448
SL050,34070505110,844,431,413,104.358353510896
SL050,34070505112,110,56,54,103.703703703704
SL050,34070505113,64,30,34,88.2352941176471
SL050,34070505114,1440,732,708,103.389830508475
SL050,34070505115,596,310,286,108.391608391608
SL050,34070505116,102,51,51,100
SL050,34070505117,208,119,89,133.707865168539
SL050,34070505118,74,40,34,117.647058823529
SL050,34070505119,27,18,9,200
SL050,34070505120,31,20,11,181.818181818182
SL050,34070505121,317,165,152,108.552631578947
SL050,34070505122,122,62,60,103.333333333333
SL050,34070505123,105,52,53,98.1132075471698
SL050,34070505124,99,45,54,83.3333333333333
SL050,34070505125,61,31,30,103.333333333333
SL050,34070505126,60,36,24,150
SL050,34070505127,704,394,310,127.096774193548
SL050,34070505128,395,207,188,110.106382978723
SL050,34070505129,124,73,51,143.137254901961
SL050,34070505130,95,50,45,111.111111111111
SL050,34070505131,92,54,38,142.105263157895
SL050,34070505132,1006,520,486,106.995884773663
SL050,34070505133,73,38,35,108.571428571429
SL050,34070505134,50,30,20,150
SL050,34070505135,394,208,186,111.827956989247
SL050,34070505136,94,50,44,113.636363636364
SL050,34070505138,334,172,162,106.172839506173
SL050,34070505139,67,37,30,123.333333333333
SL050,34070505140,128,71,57,124.561403508772
SL050,34070505141,103,57,46,123.913043478261
SL050,34070505142,96,45,51,88.2352941176471
SL050,34070505143,62,31,31,100
SL050,34070505144,77,42,35,120
SL050,34070505145,50,28,22,127.272727272727
SL050,34070505147,161,91,70,130
SL050,34070505148,22,11,11,100
SL050,34070505149,101,59,42,140.47619047619
SL050,34070505151,98,50,48,104.166666666667
SL050,34070505152,753,398,355,112.112676056338
SL050,34070505153,93,50,43,116.279069767442
SL050,34070505154,34,24,10,240
SL050,34070505155,46,30,16,187.5
SL050,34070505156,310,180,130,138.461538461538
SL050,34070505157,247,134,113,118.58407079646
SL050,34070505158,336,182,154,118.181818181818
SL050,34070505159,236,116,120,96.6666666666667
SL050,34070505160,321,176,145,121.379310344828
SL050,34070505161,777,399,378,105.555555555556
SL050,34070505162,90,47,43,109.302325581395
SL050,34070505163,1878,924,954,96.8553459119497
SL050,34070505164,16,8,8,100
SL050,34070505165,434,213,221,96.3800904977376
SL050,34070505166,168,92,76,121.052631578947
SL050,34070505167,279,155,124,125
SL050,34070505168,5139,2616,2523,103.686087990488
SL050,34070505169,251,145,106,136.792452830189
SL050,34070505170,55,27,28,96.4285714285714
SL050,34070505171,69,34,35,97.1428571428571
SL050,34070505172,184,103,81,127.16049382716
SL050,34070505173,63,39,24,162.5
SL050,34070505174,75,41,34,120.588235294118
SL050,34070505175,172,98,74,132.432432432432
SL050,34070505176,272,150,122,122.950819672131
SL050,34070505177,154,81,73,110.958904109589
SL050,34070505178,402,211,191,110.471204188482
SL050,34070505179,232,114,118,96.6101694915254
SL050,34070505180,72,39,33,118.181818181818
SL050,34070505181,43,29,14,207.142857142857
SL050,34070505182,844,444,400,111
SL050,34070505183,140,74,66,112.121212121212
SL050,34070505184,272,152,120,126.666666666667
SL050,34070505185,113,58,55,105.454545454545
SL050,34070505186,1811,869,942,92.2505307855626
SL050,34070505187,2057,1025,1032,99.3217054263566
SL050,34070505188,45,28,17,164.705882352941
SL050,34070505189,482,254,228,111.40350877193
SL050,34070505190,49,30,19,157.894736842105
SL050,34070505191,126,64,62,103.225806451613
SL050,34070505192,107,66,41,160.975609756098
SL050,34070505193,181,103,78,132.051282051282
SL050,34070505194,146,82,64,128.125
SL050,34070505195,227,135,92,146.739130434783
SL050,34070505196,65,28,37,75.6756756756757
SL050,34070505197,116,64,52,123.076923076923
SL050,34070505198,75,35,40,87.5
SL050,34070505199,42,22,20,110
SL050,34070505200,43,21,22,95.4545454545455
SL050,34070505201,553,297,256,116.015625
SL050,34070505204,726,373,353,105.665722379603
SL050,34070505205,86,43,43,100
SL050,34070505206,30,18,12,150
SL050,34070505207,747,388,359,108.077994428969
SL050,34070505208,36,22,14,157.142857142857
SL050,34070505209,80,48,32,150
SL050,34070505210,86,43,43,100
SL050,34070505211,473,251,222,113.063063063063
SL050,34070505212,199,111,88,126.136363636364
SL050,34070505213,105,64,41,156.09756097561
SL050,34070505214,37,21,16,131.25
SL050,34070505215,174,104,70,148.571428571429
SL050,34070505216,189,109,80,136.25
SL050,34070505217,55,30,25,120
SL050,34070505218,125,68,57,119.298245614035
SL050,34070505219,44,26,18,144.444444444444
SL050,34070505220,428,226,202,111.881188118812
SL050,34070505221,365,192,173,110.982658959538
SL050,34070505222,141,76,65,116.923076923077
SL050,34070505224,111,58,53,109.433962264151
SL050,34070505225,403,219,184,119.021739130435
SL050,34070505226,73,44,29,151.724137931034
SL050,34070505227,436,234,202,115.841584158416
SL050,34070505228,176,109,67,162.686567164179
SL050,34070505229,75,40,35,114.285714285714
SL050,34070505230,65,35,30,116.666666666667
SL050,34070505231,171,100,71,140.845070422535
SL050,34070505232,111,58,53,109.433962264151
SL050,34070505233,250,140,110,127.272727272727
SL050,34070505234,43,22,21,104.761904761905
SL050,34070505235,124,69,55,125.454545454545
SL050,34070505236,113,66,47,140.425531914894
SL050,34070505237,165,95,70,135.714285714286
SL050,34070505238,837,446,391,114.066496163683
SL050,34070505239,251,134,117,114.529914529915
SL050,34070505240,4542,2252,2290,98.3406113537118
SL050,34070505241,4097,2090,2007,104.135525660189
SL050,34070505242,796,411,385,106.753246753247
SL050,34070505243,85,48,37,129.72972972973
SL050,34070505244,41,26,15,173.333333333333
SL050,34070505245,435,222,213,104.225352112676
SL050,34070505246,60,33,27,122.222222222222
SL050,34070505247,239,131,108,121.296296296296
SL050,34070505249,105,55,50,110
SL050,34070505251,67,42,25,168
SL050,34070505252,62,37,25,148
SL050,34070505253,85,41,44,93.1818181818182
SL050,34070505254,213,106,107,99.0654205607477
SL050,34070505256,117,62,55,112.727272727273
SL050,34070505257,132,71,61,116.393442622951
SL050,34070505258,132,76,56,135.714285714286
SL050,34070505259,122,61,61,100
SL050,34070505260,103,57,46,123.913043478261
SL050,34070505261,39,22,17,129.411764705882
SL050,34070505262,363,191,172,111.046511627907
SL050,34070505263,166,96,70,137.142857142857
SL050,34070505264,58,34,24,141.666666666667
SL050,34070505265,87,52,35,148.571428571429
SL050,34070505266,97,53,44,120.454545454545
SL050,34070505267,115,60,55,109.090909090909
SL050,34070505901,251,137,114,120.175438596491
SL050,34070505902,314,183,131,139.69465648855
SL050,34070505903,147,83,64,129.6875
SL050,34070505904,122,69,53,130.188679245283
SL050,34070505905,254,127,127,100
SL050,34110606001,798,418,380,110
SL050,34110606002,5461,2706,2755,98.2214156079855
SL050,34110606003,893,443,450,98.4444444444444
SL050,34110606004,1880,945,935,101.069518716578
SL050,34110606005,2029,1058,971,108.959835221421
SL050,34110606006,5340,2667,2673,99.7755331088664
SL050,34110606007,1704,859,845,101.656804733728
SL050,34110606008,730,359,371,96.7654986522911
SL050,34110606009,245,133,112,118.75
SL050,34110606010,1240,607,633,95.8925750394945
SL050,34110606011,33468,16588,16880,98.2701421800948
SL050,34110606012,4126,2102,2024,103.853754940711
SL050,34110606013,293,150,143,104.895104895105
SL050,34110606014,7891,3914,3977,98.4158913754086
SL050,34110606015,150530,72988,77542,94.1270537257228
SL050,34110606016,3580,1822,1758,103.640500568828
SL050,34110606017,293,156,137,113.868613138686
SL050,34110606018,841,417,424,98.3490566037736
SL050,34110606019,2360,1192,1168,102.054794520548
SL050,34110606020,2128,1101,1027,107.205452775073
SL050,34110606021,1052,539,513,105.068226120858
SL050,34110606022,3085,1524,1561,97.6297245355541
SL050,34110606023,4929,2441,2488,98.1109324758842
SL050,34110606024,1331,679,652,104.141104294479
SL050,34110606025,6241,3101,3140,98.7579617834395
SL050,34110606026,969,490,479,102.296450939457
SL050,34110606027,769,383,386,99.2227979274611
SL050,34110606028,4967,2442,2525,96.7128712871287
SL050,34110606029,1373,693,680,101.911764705882
SL050,34110606030,186,96,90,106.666666666667
SL050,34110606031,551,276,275,100.363636363636
SL050,34110606032,67,33,34,97.0588235294118
SL050,34110606033,1483,762,721,105.686546463245
SL050,34110606034,191,94,97,96.9072164948454
SL050,34110606035,972,498,474,105.063291139241
SL050,34110606036,5921,2919,3002,97.2351765489674
SL050,34110606037,2119,1121,998,112.324649298597
SL050,34110606038,916,471,445,105.842696629213
SL050,34110606039,2182,1065,1117,95.3446732318711
SL050,34110606040,1238,607,631,96.1965134706815
SL050,34110606041,567,293,274,106.934306569343
SL050,34110606042,1210,587,623,94.2215088282504
SL050,34110606043,768,395,373,105.898123324397
SL050,34110606044,37010,18268,18742,97.4709209262619
SL050,34110606045,569,287,282,101.77304964539
SL050,34110606046,1459,720,739,97.4289580514208
SL050,34110606047,1031,528,503,104.970178926441
SL050,34110606048,938,451,487,92.6078028747433
SL050,34110606049,1150,560,590,94.9152542372881
SL050,34110606050,4918,2419,2499,96.7987194877951
SL050,34110606051,1879,931,948,98.2067510548523
SL050,34110606052,4784,2367,2417,97.9313198179562
SL050,34110606053,697,350,347,100.864553314121
SL050,34110606054,6774,3367,3407,98.8259465805694
SL050,34110606055,2311,1142,1169,97.6903336184773
SL050,34110606056,522,277,245,113.061224489796
SL050,34110606057,599,312,287,108.710801393728
SL050,34110606058,2401,1206,1195,100.92050209205
SL050,34110606059,2041,1013,1028,98.5408560311284
SL050,34110606060,7006,3530,3476,101.553509781358
SL050,34110606061,1247,622,625,99.52
SL050,34110606062,653,368,285,129.122807017544
SL050,34110606063,3485,1748,1737,100.633275762809
SL050,34110606064,941,492,449,109.576837416481
SL050,34110606065,343,174,169,102.958579881657
SL050,34110606066,1950,982,968,101.446280991736
SL050,34110606067,2264,1134,1130,100.353982300885
SL050,34110606068,489,238,251,94.8207171314741
SL050,34110606069,3639,1832,1807,101.383508577753
SL050,34110606070,9367,4610,4757,96.909817111625
SL050,34110606071,284,143,141,101.418439716312
SL050,34110606072,2757,1414,1343,105.286671630678
SL050,34110606073,860,446,414,107.729468599034
SL050,34110606074,5758,2861,2897,98.7573351743183
SL050,34110606075,526,280,246,113.821138211382
SL050,34110606076,970,478,492,97.1544715447154
SL050,34110606077,374,203,171,118.713450292398
SL050,34110606078,569,294,275,106.909090909091
SL050,34110606079,763,391,372,105.10752688172
SL050,34110606080,2276,1134,1142,99.2994746059545
SL050,34110606081,1207,621,586,105.972696245734
SL050,34110606082,472,254,218,116.51376146789
SL050,34110606083,59352,28958,30394,95.2753832993354
SL050,34110606084,1300,659,641,102.808112324493
SL050,34110606085,4254,2189,2065,106.004842615012
SL050,34110606086,1367,659,708,93.0790960451977
SL050,34110606087,2415,1177,1238,95.0726978998384
SL050,34110606088,15614,7721,7893,97.820853921196
SL050,34110606089,719,365,354,103.107344632768
SL050,34110606090,949,482,467,103.21199143469
SL050,34110606091,4444,2258,2186,103.293687099726
SL050,34110606092,666,330,336,98.2142857142857
SL050,34110606093,5195,2601,2594,100.269853508096
SL050,34110606094,1734,892,842,105.938242280285
SL050,34110606095,11986,5977,6009,99.467465468464
SL050,34110606096,235,123,112,109.821428571429
SL050,34110606097,2729,1415,1314,107.686453576865
SL050,34110606098,686,342,344,99.4186046511628
SL050,34110606099,1360,705,655,107.63358778626
SL050,34110606100,949,450,499,90.1803607214429
SL050,34110606101,512,259,253,102.371541501976
SL050,34110606102,1188,585,603,97.0149253731343
SL050,34110606103,5876,2933,2943,99.660210669385
SL050,34110606104,745,374,371,100.808625336927
SL050,34110606105,698,356,342,104.093567251462
SL050,34110606106,500,256,244,104.918032786885
SL050,34110606107,1868,938,930,100.860215053763
SL050,34110606108,2731,1377,1354,101.698670605613
SL050,34110606109,4650,2354,2296,102.526132404181
SL050,34110606110,159,79,80,98.75
SL050,34110606111,622,320,302,105.960264900662
SL050,34110606112,443,226,217,104.147465437788
SL050,34110606113,3357,1664,1693,98.2870643827525
SL050,34110606114,141,72,69,104.347826086957
SL050,34110606115,1473,727,746,97.4530831099196
SL050,34110606116,1800,907,893,101.567749160134
SL050,34110606117,1664,811,853,95.0762016412661
SL050,34110606118,175,100,75,133.333333333333
SL050,34110606119,837,433,404,107.178217821782
SL050,34110606120,4059,2056,2003,102.64603095357
SL050,34110606121,4176,2109,2067,102.031930333817
SL050,34110606122,8126,4104,4022,102.038786673297
SL050,34110606123,5475,2756,2719,101.360794409709
SL050,34110606124,1921,951,970,98.0412371134021
SL050,34110606125,1912,962,950,101.263157894737
SL050,34110606126,2645,1317,1328,99.171686746988
SL050,34110606127,3420,1704,1716,99.3006993006993
SL050,34110606128,5376,2681,2695,99.4805194805195
SL050,34110606129,681,341,340,100.294117647059
SL050,34110606130,215,111,104,106.730769230769
SL050,34110606131,1265,648,617,105.024311183144
SL050,34110606132,973,465,508,91.5354330708661
SL050,34110606133,2264,1168,1096,106.569343065693
SL050,34110606134,633,334,299,111.705685618729
SL050,34110606135,1401,720,681,105.726872246696
SL050,34110606136,1777,879,898,97.8841870824053
SL050,34110606137,1074,555,519,106.936416184971
SL050,34110606138,1179,577,602,95.8471760797342
SL050,34110606139,578,305,273,111.721611721612
SL050,34110606140,731,368,363,101.37741046832
SL050,34110606141,2008,994,1014,98.0276134122288
SL050,34110606142,281,150,131,114.503816793893
SL050,34110606143,4176,2101,2075,101.253012048193
SL050,34110606144,603,299,304,98.3552631578947
SL050,34110606145,1060,534,526,101.520912547529
SL050,34110606146,1224,620,604,102.649006622517
SL050,34110606147,367,180,187,96.2566844919786
SL050,34110606148,1152,565,587,96.252129471891
SL050,34110606149,12926,6365,6561,97.0126505105929
SL050,34110606150,913,470,443,106.094808126411
SL050,34110606151,1243,603,640,94.21875
SL050,34110606152,1504,761,743,102.422611036339
SL050,34110606153,25759,12528,13231,94.686720580455
SL050,34110606154,3401,1700,1701,99.9412110523222
SL050,34110606155,2168,1157,1011,114.441147378833
SL050,34110606156,1383,715,668,107.035928143713
SL050,34110606157,444,226,218,103.669724770642
SL050,34110606158,16776,8086,8690,93.0494821634062
SL050,34110606159,2805,1399,1406,99.50213371266
SL050,34110606160,3606,1810,1796,100.779510022272
SL050,34110606161,310,157,153,102.614379084967
SL050,34110606162,3508,1783,1725,103.36231884058
SL050,34110606901,2734,1398,1336,104.640718562874
SL050,34110606902,2033,1032,1001,103.096903096903
SL050,34110606903,2518,1237,1281,96.5651834504294
SL050,34040707001,5494,2658,2836,93.7235543018336
SL050,34040707002,9012,4520,4492,100.623330365093
SL050,34040707003,19793,9974,9819,101.578572156024
SL050,34040707004,5529,2822,2707,104.248245289989
SL050,34040707005,11004,5470,5534,98.8435128297795
SL050,34040707006,7671,3844,3827,100.44421217664
SL050,34040707007,503,265,238,111.344537815126
SL050,34040707008,8316,4130,4186,98.6622073578595
SL050,34040707009,1054,545,509,107.072691552063
SL050,34040707010,6714,3284,3430,95.7434402332362
SL050,34040707011,49333,24727,24606,100.49174997968
SL050,34040707012,2612,1302,1310,99.3893129770992
SL050,34040707013,10610,5268,5342,98.6147510295769
SL050,34040707014,11600,5907,5693,103.759002283506
SL050,34040707015,29223,14483,14740,98.2564450474898
SL050,34040707016,4008,2012,1996,100.801603206413
SL050,34040707017,1271,624,647,96.4451313755796
SL050,34040707018,620,293,327,89.6024464831804
SL050,34040707019,211,129,82,157.317073170732
SL050,34040707020,5020,2478,2542,97.4822974036192
SL050,34040707021,318,171,147,116.326530612245
SL050,34040707022,17497,8801,8696,101.207451701932
SL050,34040707023,4695,2335,2360,98.9406779661017
SL050,34040707024,12216,6428,5788,111.057360055287
SL050,34040707025,678,332,346,95.9537572254335
SL050,34040707026,49727,24984,24743,100.97401285212
SL050,34040707027,32137,16169,15968,101.25876753507
SL050,34040707028,1289,652,637,102.354788069074
SL050,34040707029,5858,2941,2917,100.822763112787
SL050,34040707030,2243,1131,1112,101.708633093525
SL050,34040707031,36358,18444,17914,102.958579881657
SL050,34040707032,28592,13990,14602,95.8087933159841
SL050,34040707033,42631,21270,21361,99.5739899817424
SL050,34040707034,1455,738,717,102.928870292887
SL050,34040707035,2143,1108,1035,107.053140096618
SL050,34040707036,36725,18495,18230,101.453647833242
SL050,34040707037,4788,2428,2360,102.881355932203
SL050,34040707038,2867,1449,1418,102.186177715092
SL050,34040707039,6931,3504,3427,102.246863145608
SL050,34040707040,409661,199652,210009,95.068306596384
SL050,34040707041,2825,1399,1426,98.1065918653576
SL050,34040707042,16189,8059,8130,99.1266912669127
SL050,34040707043,5339,2722,2617,104.012227741689
SL050,34040707044,13026,6623,6403,103.435889426831
SL050,34040707045,1967,974,993,98.0866062437059
SL050,34040707046,25779,13529,12250,110.440816326531
SL050,34040707047,3195,1615,1580,102.215189873418
SL050,34040707048,26496,13663,12833,106.467700459752
SL050,34040707049,2083,1023,1060,96.5094339622642
SL050,34040707050,6200,3153,3047,103.478831637676
SL050,34040707051,8405,4151,4254,97.5787494123178
SL050,34040707052,6892,3494,3398,102.825191288994
SL050,34040707053,1671,831,840,98.9285714285714
SL050,34040707054,36457,18517,17940,103.216276477146
SL050,34040707055,11958,6108,5850,104.410256410256
SL050,34040707056,7167,3564,3603,98.917568692756
SL050,34040707057,12112,6089,6023,101.095799435497
SL050,34040707058,3981,1994,1987,100.352289884248
SL050,34040707059,4877,2474,2403,102.954640033292
SL050,34040707060,3764,1866,1898,98.3140147523709
SL050,34040707061,14041,7050,6991,100.843942211415
SL050,34040707062,11378,5696,5682,100.246392115452
SL050,34040707063,1945,989,956,103.451882845188
SL050,34040707064,7348,3723,3625,102.703448275862
SL050,34040707065,3176,1606,1570,102.292993630573
SL050,34040707901,860,451,409,110.268948655257
SL050,34040707902,1370,683,687,99.4177583697234
SL050,34090808001,12334,6248,6086,102.66184686165
SL050,34090808002,277,148,129,114.728682170543
SL050,34090808003,9764,4751,5013,94.7735886694594
SL050,34090808004,273,146,127,114.96062992126
SL050,34090808005,8496,4285,4211,101.757302303491
SL050,34090808006,15533,7536,7997,94.2353382518444
SL050,34090808007,8838,4439,4399,100.909297567629
SL050,34090808008,219,110,109,100.917431192661
SL050,34090808009,12295,6053,6242,96.9721243191285
SL050,34090808010,5648,2851,2797,101.930639971398
SL050,34090808011,2250,1120,1130,99.1150442477876
SL050,34090808012,2250,1120,1130,99.1150442477876
SL050,34090808013,1669,887,782,113.427109974425
SL050,34090808014,2501,1204,1297,92.8296067848882
SL050,34090808015,217741,107092,110649,96.7853301882529
SL050,34090808016,2152,1075,1077,99.8142989786444
SL050,34090808017,3783,1907,1876,101.652452025586
SL050,34090808018,3205,1586,1619,97.9617047560222
SL050,34090808019,1620343,765962,854381,89.6511041326996
SL050,34090808020,6961,3440,3521,97.6995171826186
SL050,34090808021,74,46,28,164.285714285714
SL050,34090808022,16199,7979,8220,97.0681265206813
SL050,34090808023,9003,4587,4416,103.872282608696
SL050,34090808024,456,257,199,129.145728643216
SL050,34090808025,2027,1095,932,117.489270386266
SL050,34090808026,257,142,115,123.478260869565
SL050,34090808027,965,492,473,104.016913319239
SL050,34090808028,1376,726,650,111.692307692308
SL050,34090808029,4664,2346,2318,101.207937877481
SL050,34090808030,7348,3626,3722,97.4207415368082
SL050,34090808031,3547,1790,1757,101.878201479795
SL050,34090808032,2859,1380,1479,93.3062880324544
SL050,34090808033,17449,8669,8780,98.7357630979499
SL050,34090808034,946,488,458,106.550218340611
SL050,34090808035,18728,9152,9576,95.5722639933166
SL050,34090808036,191,95,96,98.9583333333333
SL050,34090808037,2497,1265,1232,102.678571428571
SL050,34090808038,2095,1025,1070,95.7943925233645
SL050,34090808039,515,272,243,111.934156378601
SL050,34090808040,14583,7075,7508,94.2328183271177
SL050,34090808041,16317,8458,7859,107.621834839038
SL050,34090808042,2995,1521,1474,103.188602442334
SL050,34090808043,4481,2310,2171,106.402579456472
SL050,34090808044,5211,2572,2639,97.461159530125
SL050,34090808045,96,45,51,88.2352941176471
SL050,34090808046,18165,8892,9273,95.8912973147849
SL050,34090808047,4652,2271,2381,95.380092398152
SL050,34090808048,783,398,385,103.376623376623
SL050,34090808049,1572,780,792,98.4848484848485
SL050,34090808050,165,92,73,126.027397260274
SL050,34090808051,24036,11855,12181,97.3237008455792
SL050,34090808052,165,86,79,108.860759493671
SL050,34090808053,3599,1841,1758,104.721274175199
SL050,34090808054,12332,6244,6088,102.562417871222
SL050,34090808055,728,377,351,107.407407407407
SL050,34090808056,66375,32747,33628,97.3801593909837
SL050,34090808057,72,41,31,132.258064516129
SL050,34090808058,2247,1147,1100,104.272727272727
SL050,34090808059,446,228,218,104.587155963303
SL050,34090808060,156,90,66,136.363636363636
SL050,34090808061,2053,1065,988,107.793522267206
SL050,34090808062,1319,666,653,101.990811638591
SL050,34090808063,610,295,315,93.6507936507936
SL050,34090808064,2418,1208,1210,99.8347107438017
SL050,34090808065,1534,772,762,101.312335958005
SL050,34090808066,1865,917,948,96.7299578059072
SL050,34090808067,7423,3643,3780,96.3756613756614
SL050,34090808068,8970,4495,4475,100.446927374302
SL050,34090808069,4458,2304,2154,106.963788300836
SL050,34090808070,339,173,166,104.21686746988
SL050,34090808071,306,151,155,97.4193548387097
SL050,34090808072,14643,7357,7286,100.974471589349
SL050,34090808073,87173,42226,44947,93.9462033061161
SL050,34090808074,14992,7554,7438,101.559559021242
SL050,34090808075,5281,2681,2600,103.115384615385
SL050,34090808076,22045,11153,10892,102.396254131473
SL050,34090808077,46355,22144,24211,91.4625583412498
SL050,34090808078,258,130,128,101.5625
SL050,34090808079,393,193,200,96.5
SL050,34090808080,42,25,17,147.058823529412
SL050,34090808081,466,245,221,110.859728506787
SL050,34090808082,1467,753,714,105.46218487395
SL050,34090808083,2276,1156,1120,103.214285714286
SL050,34090808084,1439,743,696,106.752873563218
SL050,34090808085,1354,702,652,107.668711656442
SL050,34090808086,19768,10003,9765,102.437275985663
SL050,34090808087,169,90,79,113.924050632911
SL050,34090808088,16227,7861,8366,93.9636624432226
SL050,34090808089,46705,22916,23789,96.3302366640044
SL050,34090808090,167,93,74,125.675675675676
SL050,34090808091,7371,3700,3671,100.789975483519
SL050,34090808092,4834,2396,2438,98.2772764561116
SL050,34090808093,26,15,11,136.363636363636
SL050,34090808094,2130,1077,1053,102.279202279202
SL050,34090808095,80,56,24,233.333333333333
SL050,34090808096,60981,30023,30958,96.9797790554945
SL050,34090808097,1481,750,731,102.599179206566
SL050,34090808098,3168,1624,1544,105.181347150259
SL050,34090808099,887,458,429,106.759906759907
SL050,34090808100,2654,1360,1294,105.100463678516
SL050,34090808101,261068,126066,135002,93.3808388023881
SL050,34090808102,39540,19393,20147,96.2575073211893
SL050,34090808103,841,431,410,105.121951219512
SL050,34090808104,863,469,394,119.035532994924
SL050,34090808105,13367,6595,6772,97.386296515062
SL050,34090808106,9838,4907,4931,99.5132833096735
SL050,34090808107,15111,7738,7373,104.950495049505
SL050,34090808108,6480,3299,3181,103.709525306507
SL050,34090808109,276,135,141,95.7446808510638
SL050,34090808110,18439,9217,9222,99.9457818260681
SL050,34090808111,271,140,131,106.870229007634
SL050,34090808112,20194,10068,10126,99.4272170649812
SL050,34090808113,76250,37311,38939,95.8191016718457
SL050,34090808114,27850,14179,13671,103.715894960135
SL050,34090808115,4794,2410,2384,101.090604026846
SL050,34090808116,704,354,350,101.142857142857
SL050,34090808117,3124,1543,1581,97.5964579380139
SL050,34090808118,23340,11266,12074,93.3079344045055
SL050,34090808119,8641,4338,4303,100.813386009761
SL050,34090808120,9291,4666,4625,100.886486486486
SL050,34090808121,126988,62945,64043,98.2855269116063
SL050,34090808122,2331,1170,1161,100.77519379845
SL050,34090808123,25687,12499,13188,94.7755535335153
SL050,34090808124,51133,25152,25981,96.8092067279935
SL050,34090808125,35599,17522,18077,96.9298002987221
SL050,34090808126,11819,5832,5987,97.4110572907967
SL050,34090808127,2955,1501,1454,103.232462173315
SL050,34090808128,677,357,320,111.5625
SL050,34090808129,620,316,304,103.947368421053
SL050,34090808130,129,66,63,104.761904761905
SL050,34090808131,968,492,476,103.361344537815
SL050,34090808132,465,237,228,103.947368421053
SL050,34090808133,154,88,66,133.333333333333
SL050,34090808134,1109,551,558,98.7455197132616
SL050,34090808135,8784,4298,4486,95.8091841283995
SL050,34090808136,16263,8167,8096,100.876976284585
SL050,34090808137,321,166,155,107.096774193548
SL050,34090808138,6190,3147,3043,103.41767992113
SL050,34090808139,223,121,102,118.627450980392
SL050,34090808140,5966,2917,3049,95.670711708757
SL050,34090808141,6023,2988,3035,98.4514003294893
SL050,34090808142,160,81,79,102.53164556962
SL050,34090808143,3608,1847,1761,104.88358886996
SL050,34090808144,837,405,432,93.75
SL050,34090808145,3611,1855,1756,105.637813211845
SL050,34090808146,1787,941,846,111.229314420804
SL050,34090808147,23779,11860,11919,99.5049920295327
SL050,34090808148,3729,1962,1767,111.035653650255
SL050,34090808149,1188,587,601,97.6705490848586
SL050,34090808150,310,156,154,101.298701298701
SL050,34090808151,537,268,269,99.6282527881041
SL050,34090808152,136,75,61,122.950819672131
SL050,34090808153,730,375,355,105.633802816901
SL050,34090808154,908,455,453,100.441501103753
SL050,34090808155,9256,4652,4604,101.042571676803
SL050,34090808156,14636,7160,7476,95.7731407169609
SL050,34090808157,11486,5725,5761,99.3751084881097
SL050,34090808158,4103,2031,2072,98.0212355212355
SL050,34090808159,19041,9551,9490,100.642781875659
SL050,34090808160,412,210,202,103.960396039604
SL050,34090808161,15362,7848,7514,104.445035932925
SL050,34090808162,2930,1502,1428,105.182072829132
SL050,34090808163,26659,13254,13405,98.8735546437896
SL050,34090808164,1259,634,625,101.44
SL050,34090808165,2177,1109,1068,103.838951310861
SL050,34090808166,1101,535,566,94.5229681978799
SL050,34090808167,8389,4230,4159,101.707141139697
SL050,34090808168,458,258,200,129
SL050,34090808169,64132,31413,32719,96.0084354656316
SL050,34090808170,545,288,257,112.062256809339
SL050,34090808171,2537,1273,1264,100.712025316456
SL050,34090808172,28071,13720,14351,95.603093861055
SL050,34090808174,518,257,261,98.4674329501916
SL050,34090808175,4094,2024,2070,97.7777777777778
SL050,34090808176,207,113,94,120.212765957447
SL050,34090808177,60,32,28,114.285714285714
SL050,34090808178,539,274,265,103.396226415094
SL050,34090808179,747,386,361,106.925207756233
SL050,34090808180,38347,18980,19367,98.0017555635876
SL050,34090808181,10666,5314,5352,99.2899850523169
SL050,34090808182,3801,1959,1842,106.351791530945
SL050,34090808183,6197,3039,3158,96.2317922735909
SL050,34090808184,76423,37840,38583,98.0742814192779
SL050,34090808185,232,129,103,125.242718446602
SL050,34090808187,211734,102927,108807,94.5959359232402
SL050,34090808188,161,90,71,126.760563380282
SL050,34090808189,155,84,71,118.30985915493
SL050,34090808190,265,154,111,138.738738738739
SL050,34090808191,6636,3194,3442,92.7948866937827
SL050,34090808192,7532,3739,3793,98.5763248088584
SL050,34090808193,1313,677,636,106.446540880503
SL050,34090808194,36669,18028,18641,96.7115498095596
SL050,34090808195,87,44,43,102.325581395349
SL050,34090808196,27332,13552,13780,98.3454281567489
SL050,34090808197,10877,5370,5507,97.5122571272925
SL050,34090808198,6095,3032,3063,98.9879203395364
SL050,34090808199,840,446,394,113.197969543147
SL050,34090808200,82904,40601,42303,95.9766446824102
SL050,34090808201,532,260,272,95.5882352941177
SL050,34090808202,17754,8833,8921,99.0135635018496
SL050,34090808203,3344,1743,1601,108.869456589631
SL050,34090808204,4107,2074,2033,102.016724053123
SL050,34090808205,90664,44106,46558,94.7334507496027
SL050,34090808206,989,474,515,92.0388349514563
SL050,34090808207,2749,1359,1390,97.7697841726619
SL050,34090808208,7800,3920,3880,101.030927835052
SL050,34090808209,8722,4330,4392,98.5883424408015
SL050,34090808210,6184,3132,3052,102.62123197903
SL050,34090808211,44474,21536,22938,93.8878716540239
SL050,34090808212,600,316,284,111.267605633803
SL050,34090808213,8593,4256,4337,98.1323495503805
SL050,34090808214,9013,4435,4578,96.8763652249891
SL050,34090808215,3475,1721,1754,98.1185860889396
SL050,34090808216,30,18,12,150
SL050,34090808217,34084,16569,17515,94.5989152155295
SL050,34090808218,10820,5422,5398,100.444609114487
SL050,34090808219,20764,10018,10746,93.2253861902103
SL050,34090808220,3096,1529,1567,97.5749840459477
SL050,34090808221,17494,8361,9133,91.5471367568159
SL050,34090808222,2598,1323,1275,103.764705882353
SL050,34090808223,2371,1190,1181,100.762066045724
SL050,34090808224,1131,590,541,109.0573012939
SL050,34090808225,113,56,57,98.2456140350877
SL050,34090808226,1206,616,590,104.406779661017
SL050,34090808227,3231,1591,1640,97.0121951219512
SL050,34090808228,344,179,165,108.484848484848
SL050,34090808229,600,300,300,100
SL050,34090808230,10429,5206,5223,99.6745165613632
SL050,34090808231,30658,15311,15347,99.7654264677136
SL050,34090808232,2338,1161,1177,98.6406117247239
SL050,34090808233,2419,1251,1168,107.106164383562
SL050,34090808234,4371,2168,2203,98.411257376305
SL050,34090808235,5178,2563,2615,98.0114722753346
SL050,34090808236,2179,1119,1060,105.566037735849
SL050,34090808237,2107,1027,1080,95.0925925925926
SL050,34090808238,19939,9754,10185,95.7682866961217
SL050,34090808239,637,332,305,108.852459016393
SL050,34090808240,12866,6322,6544,96.6075794621027
SL050,34090808241,79,46,33,139.393939393939
SL050,34090808242,258,127,131,96.9465648854962
SL050,34090808243,187,96,91,105.494505494505
SL050,34090808244,8179,4018,4161,96.563326123528
SL050,34090808245,118821,58849,59972,98.1274594810912
SL050,34090808246,2226,1130,1096,103.102189781022
SL050,34090808247,1309,670,639,104.851330203443
SL050,34090808248,7192,3601,3591,100.278473962684
SL050,34090808249,379,191,188,101.595744680851
SL050,34090808250,9874,4940,4934,100.121605188488
SL050,34090808251,7503,3802,3701,102.72899216428
SL050,34090808252,32839,16167,16672,96.9709692898273
SL050,34090808253,143,72,71,101.408450704225
SL050,34090808254,2141,1083,1058,102.362948960302
SL050,34090808255,183,90,93,96.7741935483871
SL050,34090808256,882,439,443,99.0970654627539
SL050,34090808257,128,69,59,116.949152542373
SL050,34090808258,1024,516,508,101.574803149606
SL050,34090808259,9325,4673,4652,100.451418744626
SL050,34090808260,25705,12933,12772,101.260569996868
SL050,34090808261,3381,1700,1681,101.130279595479
SL050,34090808262,9274,4620,4654,99.2694456381607
SL050,34090808263,27901,13846,14055,98.5129847029527
SL050,34090808264,6372,3194,3178,100.503461296413
SL050,34090808265,2014,993,1021,97.2575905974535
SL050,34090808266,57740,28259,29481,95.8549574302093
SL050,34090808267,8957,4532,4425,102.418079096045
SL050,34090808268,1152,567,585,96.9230769230769
SL050,34090808269,3472,1746,1726,101.158748551564
SL050,34090808270,28969,14476,14493,99.8827019940661
SL050,34090808271,79,34,45,75.5555555555556
SL050,34090808272,205,115,90,127.777777777778
SL050,34090808273,3025,1556,1469,105.922396187883
SL050,34090808274,5895,2874,3021,95.1340615690169
SL050,34090808275,320,159,161,98.7577639751553
SL050,34090808276,333,174,159,109.433962264151
SL050,34090808277,202,115,87,132.183908045977
SL050,34090808278,6412,3188,3224,98.8833746898263
SL050,34090808279,218535,107540,110995,96.8872471732961
SL050,34090808280,111,58,53,109.433962264151
SL050,34090808281,6312,3093,3219,96.0857409133271
SL050,34090808282,8709,4170,4539,91.8704560475876
SL050,34090808283,8131,4024,4107,97.9790601412223
SL050,34090808284,16937,8576,8361,102.571462743691
SL050,34090808285,14172,7021,7151,98.1820724374213
SL050,34090808286,3716,1911,1805,105.872576177285
SL050,34090808287,1430,736,694,106.051873198847
SL050,34090808288,2281,1219,1062,114.783427495292
SL050,34090808289,5945,2941,3004,97.9027962716378
SL050,34090808290,2069,1038,1031,100.678952473327
SL050,34090808291,6486,3340,3146,106.166560712015
SL050,34090808292,1399,729,670,108.805970149254
SL050,34090808293,246,139,107,129.906542056075
SL050,34090808294,2854,1427,1427,100
SL050,34090808295,14877,7441,7436,100.067240451856
SL050,34090808296,2530,1297,1233,105.190592051906
SL050,34090808297,170,95,75,126.666666666667
SL050,34090808298,45040,22626,22414,100.945837423039
SL050,34090808299,430,226,204,110.78431372549
SL050,34090808300,7480,3707,3773,98.2507288629738
SL050,34090808301,66168,32785,33383,98.2086690830662
SL050,34090808302,12361,6178,6183,99.919133106906
SL050,34090808303,308,143,165,86.6666666666667
SL050,34090808304,1106,582,524,111.068702290076
SL050,34090808305,40055,19552,20503,95.3616543920402
SL050,34090808306,688,343,345,99.4202898550725
SL050,34090808307,66274,32079,34195,93.8119608129844
SL050,34090808308,164,86,78,110.25641025641
SL050,34090808901,279,139,140,99.2857142857143
SL050,34090808902,5339,2701,2638,102.388172858226
SL050,34090808903,244,133,111,119.81981981982
SL050,34090808904,13417,6565,6852,95.8114419147694
SL050,34090808905,2982,1458,1524,95.6692913385827
SL050,34070909001,27,19,8,237.5
SL050,34070909003,219,110,109,100.917431192661
SL050,34070909006,57,35,22,159.090909090909
SL050,34070909007,61,38,23,165.217391304348
SL050,34070909009,214,111,103,107.766990291262
SL050,34070909010,36,26,10,260
SL050,34070909011,77,46,31,148.387096774194
SL050,34070909012,100,57,43,132.558139534884
SL050,34070909013,53,31,22,140.909090909091
SL050,34070909014,186,111,75,148
SL050,34070909016,105,60,45,133.333333333333
SL050,34070909017,135,74,61,121.311475409836
SL050,34070909018,32523,15805,16718,94.5388204330661
SL050,34070909019,161,99,62,159.677419354839
SL050,34070909020,326,176,150,117.333333333333
SL050,34070909021,56,34,22,154.545454545455
SL050,34070909022,73,42,31,135.483870967742
SL050,34070909023,1684,895,789,113.434727503169
SL050,34070909024,182,107,75,142.666666666667
SL050,34070909025,126,65,61,106.55737704918
SL050,34070909026,408,252,156,161.538461538462
SL050,34070909027,49,29,20,145
SL050,34070909029,172,98,74,132.432432432432
SL050,34070909030,129,75,54,138.888888888889
SL050,34070909032,112,60,52,115.384615384615
SL050,34070909033,73,45,28,160.714285714286
SL050,34070909034,311,173,138,125.36231884058
SL050,34070909035,342,201,141,142.553191489362
SL050,34070909036,34,19,15,126.666666666667
SL050,34070909037,109,64,45,142.222222222222
SL050,34070909038,143,76,67,113.432835820896
SL050,34070909039,67,41,26,157.692307692308
SL050,34070909041,33,19,14,135.714285714286
SL050,34070909043,194,115,79,145.569620253165
SL050,34070909044,53,28,25,112
SL050,34070909045,285,159,126,126.190476190476
SL050,34070909046,25,16,9,177.777777777778
SL050,34070909047,67,34,33,103.030303030303
SL050,34070909048,1816,926,890,104.044943820225
SL050,34070909050,55,31,24,129.166666666667
SL050,34070909051,184,100,84,119.047619047619
SL050,34070909052,29,21,8,262.5
SL050,34070909054,98,61,37,164.864864864865
SL050,34070909055,55,31,24,129.166666666667
SL050,34070909056,6675,3323,3352,99.1348448687351
SL050,34070909057,173,114,59,193.220338983051
SL050,34070909058,543,299,244,122.540983606557
SL050,34070909059,175921,83728,92193,90.818174915666
SL050,34070909060,149,79,70,112.857142857143
SL050,34070909061,169,94,75,125.333333333333
SL050,34070909062,53,26,27,96.2962962962963
SL050,34070909063,233,138,95,145.263157894737
SL050,34070909064,433,227,206,110.194174757282
SL050,34070909065,162,98,64,153.125
SL050,34070909066,61,45,16,281.25
SL050,34070909067,470,246,224,109.821428571429
SL050,34070909068,27,15,12,125
SL050,34070909070,33,24,9,266.666666666667
SL050,34070909071,44,25,19,131.578947368421
SL050,34070909072,411,223,188,118.617021276596
SL050,34070909073,1313,722,591,122.165820642978
SL050,34070909074,1101,569,532,106.954887218045
SL050,34070909075,112,65,47,138.297872340426
SL050,34070909076,25,19,6,316.666666666667
SL050,34070909077,33,16,17,94.1176470588235
SL050,34070909078,37,21,16,131.25
SL050,34070909079,50,30,20,150
SL050,34070909082,36,21,15,140
SL050,34070909083,32,18,14,128.571428571429
SL050,34070909084,185,119,66,180.30303030303
SL050,34070909085,632,345,287,120.209059233449
SL050,34070909086,792,453,339,133.628318584071
SL050,34070909088,62,38,24,158.333333333333
SL050,34070909090,52,28,24,116.666666666667
SL050,34070909091,803,417,386,108.031088082902
SL050,34070909093,177,94,83,113.253012048193
SL050,34070909094,54,33,21,157.142857142857
SL050,34070909095,115,57,58,98.2758620689655
SL050,34070909098,575,313,262,119.465648854962
SL050,34070909100,57,37,20,185
SL050,34070909101,78,46,32,143.75
SL050,34070909102,33,22,11,200
SL050,34070909103,224,124,100,124
SL050,34070909104,44,23,21,109.52380952381
SL050,34070909105,101,58,43,134.883720930233
SL050,34070909108,545,299,246,121.544715447154
SL050,34070909109,1352,768,584,131.506849315069
SL050,34070909110,80,50,30,166.666666666667
SL050,34070909112,112,69,43,160.46511627907
SL050,34070909113,545,289,256,112.890625
SL050,34070909114,95,53,42,126.190476190476
SL050,34070909115,98,55,43,127.906976744186
SL050,34070909117,85,43,42,102.380952380952
SL050,34070909119,45,16,29,55.1724137931034
SL050,34070909120,42,24,18,133.333333333333
SL050,34070909122,95,60,35,171.428571428571
SL050,34070909123,44,27,17,158.823529411765
SL050,34070909124,1696,891,805,110.683229813665
SL050,34070909125,608,363,245,148.163265306122
SL050,34070909127,52,31,21,147.619047619048
SL050,34070909128,84,49,35,140
SL050,34070909129,101,66,35,188.571428571429
SL050,34070909130,76,47,29,162.068965517241
SL050,34070909131,653,342,311,109.967845659164
SL050,34070909132,181,112,69,162.31884057971
SL050,34070909133,45,25,20,125
SL050,34070909134,254,133,121,109.917355371901
SL050,34070909135,41,22,19,115.789473684211
SL050,34070909136,227,124,103,120.388349514563
SL050,34070909137,235,118,117,100.854700854701
SL050,34070909138,83,45,38,118.421052631579
SL050,34070909139,107,69,38,181.578947368421
SL050,34070909140,126,77,49,157.142857142857
SL050,34070909141,775,400,375,106.666666666667
SL050,34070909143,29,18,11,163.636363636364
SL050,34070909144,45,29,16,181.25
SL050,34070909148,100,51,49,104.081632653061
SL050,34070909149,37,28,9,311.111111111111
SL050,34070909151,548,310,238,130.252100840336
SL050,34070909152,310,171,139,123.021582733813
SL050,34070909154,155,89,66,134.848484848485
SL050,34070909155,26,16,10,160
SL050,34070909159,69,43,26,165.384615384615
SL050,34070909160,91,59,32,184.375
SL050,34070909162,156,82,74,110.810810810811
SL050,34070909163,669,371,298,124.496644295302
SL050,34070909164,180,109,71,153.521126760563
SL050,34070909166,105,61,44,138.636363636364
SL050,34070909167,58,36,22,163.636363636364
SL050,34070909168,337,182,155,117.41935483871
SL050,34070909169,103,69,34,202.941176470588
SL050,34070909170,223,120,103,116.504854368932
SL050,34070909172,136,70,66,106.060606060606
SL050,34070909173,133,75,58,129.310344827586
SL050,34070909174,932,507,425,119.294117647059
SL050,34070909175,121,82,39,210.25641025641
SL050,34070909176,62,42,20,210
SL050,34070909177,1405,764,641,119.188767550702
SL050,34070909178,45,29,16,181.25
SL050,34070909179,41,22,19,115.789473684211
SL050,34070909180,137,76,61,124.590163934426
SL050,34070909181,307,160,147,108.843537414966
SL050,34070909182,78,45,33,136.363636363636
SL050,34070909183,49,31,18,172.222222222222
SL050,34070909184,8,6,2,300
SL050,34070909189,131,72,59,122.033898305085
SL050,34070909190,86,48,38,126.315789473684
SL050,34070909191,33,20,13,153.846153846154
SL050,34070909192,55,31,24,129.166666666667
SL050,34070909194,2560,1281,1279,100.156372165754
SL050,34070909195,60,39,21,185.714285714286
SL050,34070909196,147,89,58,153.448275862069
SL050,34070909197,168,109,59,184.745762711864
SL050,34070909198,112,65,47,138.297872340426
SL050,34070909199,100,56,44,127.272727272727
SL050,34070909200,52,31,21,147.619047619048
SL050,34070909201,29,21,8,262.5
SL050,34070909202,22,14,8,175
SL050,34070909206,56,32,24,133.333333333333
SL050,34070909208,211,111,100,111
SL050,34070909209,5816,2958,2858,103.498950314906
SL050,34070909211,1611,866,745,116.241610738255
SL050,34070909213,313,172,141,121.985815602837
SL050,34070909214,733,438,295,148.474576271186
SL050,34070909215,402,227,175,129.714285714286
SL050,34070909216,429,222,207,107.246376811594
SL050,34070909217,386,222,164,135.365853658537
SL050,34070909218,451,244,207,117.874396135266
SL050,34070909219,35477,17433,18044,96.6138328530259
SL050,34070909220,71,47,24,195.833333333333
SL050,34070909221,669,369,300,123
SL050,34070909223,44,29,15,193.333333333333
SL050,34070909224,164,89,75,118.666666666667
SL050,34070909225,87,52,35,148.571428571429
SL050,34070909226,59,36,23,156.521739130435
SL050,34070909227,148,78,70,111.428571428571
SL050,34070909228,172,92,80,115
SL050,34070909229,224,121,103,117.47572815534
SL050,34070909230,35,18,17,105.882352941176
SL050,34070909231,65,47,18,261.111111111111
SL050,34070909232,158,93,65,143.076923076923
SL050,34070909235,189,110,79,139.240506329114
SL050,34070909236,37,22,15,146.666666666667
SL050,34070909238,1024,538,486,110.699588477366
SL050,34070909239,55,31,24,129.166666666667
SL050,34070909241,328,177,151,117.218543046358
SL050,34070909242,78,44,34,129.411764705882
SL050,34070909243,77,47,30,156.666666666667
SL050,34070909244,50,25,25,100
SL050,34070909246,721,371,350,106
SL050,34070909247,24,12,12,100
SL050,34070909248,82,48,34,141.176470588235
SL050,34070909249,52,29,23,126.086956521739
SL050,34070909250,282,152,130,116.923076923077
SL050,34070909251,436,239,197,121.319796954315
SL050,34070909253,117,69,48,143.75
SL050,34070909255,90,52,38,136.842105263158
SL050,34070909256,438,253,185,136.756756756757
SL050,34070909257,94,57,37,154.054054054054
SL050,34070909258,174,93,81,114.814814814815
SL050,34070909259,251,149,102,146.078431372549
SL050,34070909261,527,261,266,98.1203007518797
SL050,34070909262,167,91,76,119.736842105263
SL050,34070909265,38,22,16,137.5
SL050,34070909266,103,66,37,178.378378378378
SL050,34070909267,111,66,45,146.666666666667
SL050,34070909268,111,62,49,126.530612244898
SL050,34070909269,36,21,15,140
SL050,34070909270,167,96,71,135.211267605634
SL050,34070909272,294,155,139,111.510791366906
SL050,34070909273,53,33,20,165
SL050,34070909274,1169,586,583,100.514579759863
SL050,34070909275,179,110,69,159.420289855072
SL050,34070909276,495,269,226,119.026548672566
SL050,34070909277,115,78,37,210.810810810811
SL050,34070909279,238,142,96,147.916666666667
SL050,34070909280,24,14,10,140
SL050,34070909281,154,80,74,108.108108108108
SL050,34070909283,46,24,22,109.090909090909
SL050,34070909287,267,154,113,136.283185840708
SL050,34070909288,111,63,48,131.25
SL050,34070909289,1690,892,798,111.779448621554
SL050,34070909292,79,48,31,154.838709677419
SL050,34070909294,114,69,45,153.333333333333
SL050,34070909295,57,28,29,96.551724137931
SL050,34070909297,376,217,159,136.477987421384
SL050,34070909298,87,49,38,128.947368421053
SL050,34070909301,803,426,377,112.997347480106
SL050,34070909302,108,66,42,157.142857142857
SL050,34070909303,83,51,32,159.375
SL050,34070909304,208,111,97,114.432989690722
SL050,34070909306,112,61,51,119.607843137255
SL050,34070909307,115,72,43,167.441860465116
SL050,34070909308,68,39,29,134.48275862069
SL050,34070909309,349,185,164,112.80487804878
SL050,34070909310,11,8,3,266.666666666667
SL050,34070909311,59,37,22,168.181818181818
SL050,34070909312,107,60,47,127.659574468085
SL050,34070909314,94,60,34,176.470588235294
SL050,34070909315,523,269,254,105.905511811024
SL050,34070909316,115,73,42,173.809523809524
SL050,34070909317,19,7,12,58.3333333333333
SL050,34070909318,60,38,22,172.727272727273
SL050,34070909321,2185,1104,1081,102.127659574468
SL050,34070909323,65,43,22,195.454545454545
SL050,34070909325,193,117,76,153.947368421053
SL050,34070909326,183,106,77,137.662337662338
SL050,34070909327,36,18,18,100
SL050,34070909328,65,31,34,91.1764705882353
SL050,34070909329,131,76,55,138.181818181818
SL050,34070909330,1955,1007,948,106.223628691983
SL050,34070909332,169,92,77,119.480519480519
SL050,34070909334,51,41,10,410
SL050,34070909335,88,55,33,166.666666666667
SL050,34070909337,142,79,63,125.396825396825
SL050,34070909338,298,168,130,129.230769230769
SL050,34070909339,141,82,59,138.983050847458
SL050,34070909340,79,56,23,243.478260869565
SL050,34070909343,101,61,40,152.5
SL050,34070909345,140,87,53,164.150943396226
SL050,34070909346,99,65,34,191.176470588235
SL050,34070909347,145,74,71,104.225352112676
SL050,34070909348,141,74,67,110.44776119403
SL050,34070909350,537,291,246,118.292682926829
SL050,34070909351,62,45,17,264.705882352941
SL050,34070909352,104,66,38,173.684210526316
SL050,34070909353,91,54,37,145.945945945946
SL050,34070909354,35,26,9,288.888888888889
SL050,34070909355,85,46,39,117.948717948718
SL050,34070909356,45,28,17,164.705882352941
SL050,34070909358,279,172,107,160.747663551402
SL050,34070909360,25,20,5,400
SL050,34070909361,114,64,50,128
SL050,34070909362,245,135,110,122.727272727273
SL050,34070909363,995,562,433,129.792147806005
SL050,34070909365,31,22,9,244.444444444444
SL050,34070909366,77,45,32,140.625
SL050,34070909368,23,16,7,228.571428571429
SL050,34070909369,490,255,235,108.510638297872
SL050,34070909372,268,143,125,114.4
SL050,34070909373,448,258,190,135.789473684211
SL050,34070909374,103,66,37,178.378378378378
SL050,34070909375,38,21,17,123.529411764706
SL050,34070909377,782,422,360,117.222222222222
SL050,34070909378,29,17,12,141.666666666667
SL050,34070909380,80,38,42,90.4761904761905
SL050,34070909381,34,20,14,142.857142857143
SL050,34070909382,24,17,7,242.857142857143
SL050,34070909384,346,189,157,120.382165605096
SL050,34070909386,65,37,28,132.142857142857
SL050,34070909387,126,81,45,180
SL050,34070909388,30,16,14,114.285714285714
SL050,34070909389,68,39,29,134.48275862069
SL050,34070909390,657,356,301,118.272425249169
SL050,34070909391,458,242,216,112.037037037037
SL050,34070909392,57,32,25,128
SL050,34070909394,809,414,395,104.810126582278
SL050,34070909395,134,81,53,152.830188679245
SL050,34070909396,160,85,75,113.333333333333
SL050,34070909398,79,52,27,192.592592592593
SL050,34070909400,369,201,168,119.642857142857
SL050,34070909403,104,62,42,147.619047619048
SL050,34070909405,136,75,61,122.950819672131
SL050,34070909406,333,189,144,131.25
SL050,34070909407,29,17,12,141.666666666667
SL050,34070909408,42,26,16,162.5
SL050,34070909409,126,67,59,113.559322033898
SL050,34070909410,3739,1911,1828,104.540481400438
SL050,34070909411,157,96,61,157.377049180328
SL050,34070909412,948,515,433,118.937644341801
SL050,34070909413,477,247,230,107.391304347826
SL050,34070909414,195,114,81,140.740740740741
SL050,34070909415,321,176,145,121.379310344828
SL050,34070909416,50,28,22,127.272727272727
SL050,34070909417,42,24,18,133.333333333333
SL050,34070909418,83,42,41,102.439024390244
SL050,34070909419,76,48,28,171.428571428571
SL050,34070909421,239,139,100,139
SL050,34070909422,17,9,8,112.5
SL050,34070909423,29,19,10,190
SL050,34070909424,42,25,17,147.058823529412
SL050,34070909425,549,301,248,121.370967741935
SL050,34070909427,1527,843,684,123.245614035088
SL050,34070909428,105,61,44,138.636363636364
SL050,34070909429,59,44,15,293.333333333333
SL050,34070909430,24,15,9,166.666666666667
SL050,34070909431,119,73,46,158.695652173913
SL050,34070909432,191,110,81,135.802469135802
SL050,34070909433,61,39,22,177.272727272727
SL050,34070909434,1785,938,847,110.743801652893
SL050,34070909437,309,167,142,117.605633802817
SL050,34070909438,673,354,319,110.971786833856
SL050,34070909439,1406,763,643,118.662519440124
SL050,34070909440,88,54,34,158.823529411765
SL050,34070909441,71,42,29,144.827586206897
SL050,34070909442,438,236,202,116.831683168317
SL050,34070909443,175,85,90,94.4444444444444
SL050,34070909444,68,35,33,106.060606060606
SL050,34070909445,45,32,13,246.153846153846
SL050,34070909446,12,7,5,140
SL050,34070909447,46,28,18,155.555555555556
SL050,34070909448,217,133,84,158.333333333333
SL050,34070909449,108,63,45,140
SL050,34070909450,30,19,11,172.727272727273
SL050,34070909451,278,144,134,107.462686567164
SL050,34070909454,41,27,14,192.857142857143
SL050,34070909455,45,28,17,164.705882352941
SL050,34070909456,150,80,70,114.285714285714
SL050,34070909458,644,358,286,125.174825174825
SL050,34070909460,189,112,77,145.454545454545
SL050,34070909463,276,170,106,160.377358490566
SL050,34070909464,40,23,17,135.294117647059
SL050,34070909466,112,65,47,138.297872340426
SL050,34070909467,75,50,25,200
SL050,34070909471,194,98,96,102.083333333333
SL050,34070909472,58,36,22,163.636363636364
SL050,34070909473,87,50,37,135.135135135135
SL050,34070909476,74,47,27,174.074074074074
SL050,34070909478,43,30,13,230.769230769231
SL050,34070909480,112,58,54,107.407407407407
SL050,34070909482,31,19,12,158.333333333333
SL050,34070909483,226,117,109,107.339449541284
SL050,34070909485,58,36,22,163.636363636364
SL050,34070909901,383,200,183,109.289617486339
SL050,34070909902,480,277,203,136.453201970443
SL050,34070909903,4207,2152,2055,104.720194647202
SL050,34070909904,514,300,214,140.18691588785
SL050,34070909905,427,244,183,133.333333333333
SL050,34070909906,1443,798,645,123.720930232558
SL050,34070909907,2007,1071,936,114.423076923077
SL050,34070909908,498,290,208,139.423076923077
SL050,34111010001,335,189,146,129.452054794521
SL050,34111010002,403,207,196,105.612244897959
SL050,34111010003,580,294,286,102.797202797203
SL050,34111010004,801,399,402,99.2537313432836
SL050,34111010005,607,312,295,105.762711864407
SL050,34111010006,1401,723,678,106.637168141593
SL050,34111010007,663,337,326,103.374233128834
SL050,34111010008,1480,738,742,99.4609164420485
SL050,34111010009,225,112,113,99.1150442477876
SL050,34111010010,2646,1384,1262,109.667194928685
SL050,34111010011,576,289,287,100.696864111498
SL050,34111010012,620,288,332,86.7469879518072
SL050,34111010013,305,163,142,114.788732394366
SL050,34111010014,2085,1026,1059,96.8838526912181
SL050,34111010015,753,367,386,95.0777202072539
SL050,34111010016,370,194,176,110.227272727273
SL050,34111010017,831,416,415,100.240963855422
SL050,34111010018,1850,948,902,105.09977827051
SL050,34111010019,1765,902,863,104.519119351101
SL050,34111010020,1838,901,937,96.1579509071505
SL050,34111010021,5851,2912,2939,99.0813201769309
SL050,34111010022,444,222,222,100
SL050,34111010023,736,390,346,112.71676300578
SL050,34111010024,776,365,411,88.8077858880779
SL050,34111010025,407,209,198,105.555555555556
SL050,34111010026,729,378,351,107.692307692308
SL050,34111010027,77,43,34,126.470588235294
SL050,34111010028,91,50,41,121.951219512195
SL050,34111010029,437,232,205,113.170731707317
SL050,34111010030,500,260,240,108.333333333333
SL050,34111010031,187,106,81,130.864197530864
SL050,34111010032,1867,926,941,98.4059511158342
SL050,34111010033,434,232,202,114.851485148515
SL050,34111010034,349,176,173,101.734104046243
SL050,34111010035,2151,1104,1047,105.444126074499
SL050,34111010036,345,189,156,121.153846153846
SL050,34111010037,96068,46051,50017,92.0706959633725
SL050,34111010038,78,39,39,100
SL050,34111010039,428,217,211,102.843601895735
SL050,34111010040,490,252,238,105.882352941176
SL050,34111010041,1185,621,564,110.106382978723
SL050,34111010042,62,25,37,67.5675675675676
SL050,34111010043,856,421,435,96.7816091954023
SL050,34111010044,1634,860,774,111.111111111111
SL050,34111010045,1019,500,519,96.3391136801541
SL050,34111010046,208,110,98,112.244897959184
SL050,34111010047,1110,552,558,98.9247311827957
SL050,34111010048,230,113,117,96.5811965811966
SL050,34111010049,4500,2217,2283,97.1090670170828
SL050,34111010050,1124,571,553,103.254972875226
SL050,34111010051,386,194,192,101.041666666667
SL050,34111010052,163,81,82,98.780487804878
SL050,34111010053,301,164,137,119.70802919708
SL050,34111010054,581,285,296,96.2837837837838
SL050,34111010055,815,420,395,106.329113924051
SL050,34111010056,585,293,292,100.342465753425
SL050,34111010057,140,85,55,154.545454545455
SL050,34111010058,1381,715,666,107.357357357357
SL050,34111010059,375,182,193,94.300518134715
SL050,34111010060,1053,542,511,106.066536203523
SL050,34111010061,1854,950,904,105.088495575221
SL050,34111010062,449,236,213,110.798122065728
SL050,34111010063,170,84,86,97.6744186046512
SL050,34111010064,1650,838,812,103.20197044335
SL050,34111010065,190,105,85,123.529411764706
SL050,34111010066,185,109,76,143.421052631579
SL050,34111010067,12531,6164,6367,96.811685252081
SL050,34111010068,846,442,404,109.405940594059
SL050,34111010069,864,435,429,101.398601398601
SL050,34111010070,728,364,364,100
SL050,34111010071,120,71,49,144.897959183673
SL050,34111010072,915,466,449,103.786191536748
SL050,34111010073,849,445,404,110.148514851485
SL050,34111010075,275,150,125,120
SL050,34111010076,953,478,475,100.631578947368
SL050,34111010077,725,375,350,107.142857142857
SL050,34111010078,392,214,178,120.224719101124
SL050,34111010079,984,518,466,111.158798283262
SL050,34111010080,403,208,195,106.666666666667
SL050,34111010081,128,71,57,124.561403508772
SL050,34111010082,2054,1020,1034,98.6460348162476
SL050,34111010083,98,52,46,113.04347826087
SL050,34111010084,1493,774,719,107.649513212796
SL050,34111010085,363,186,177,105.084745762712
SL050,34111010086,335,175,160,109.375
SL050,34111010087,1887,931,956,97.3849372384937
SL050,34111010088,204,107,97,110.309278350515
SL050,34111010089,1529,770,759,101.449275362319
SL050,34111010090,536,281,255,110.196078431373
SL050,34111010091,387,203,184,110.326086956522
SL050,34111010092,299,155,144,107.638888888889
SL050,34111010093,457,228,229,99.5633187772926
SL050,34111010094,255,131,124,105.645161290323
SL050,34111010095,342,176,166,106.024096385542
SL050,34111010096,4052,1992,2060,96.6990291262136
SL050,34111010097,102,62,40,155
SL050,34111010098,396,206,190,108.421052631579
SL050,34111010099,647,322,325,99.0769230769231
SL050,34111010100,906,444,462,96.1038961038961
SL050,34111010101,216,108,108,100
SL050,34111010102,564,276,288,95.8333333333333
SL050,34111010103,489,242,247,97.9757085020243
SL050,34111010104,6477,3232,3245,99.5993836671803
SL050,34111010105,2868,1429,1439,99.3050729673384
SL050,34111010106,141,73,68,107.352941176471
SL050,34111010107,1266,636,630,100.952380952381
SL050,34111010108,201,106,95,111.578947368421
SL050,34111010109,2007,1008,999,100.900900900901
SL050,34111010110,2749,1420,1329,106.847253574116
SL050,34111010111,1595,836,759,110.144927536232
SL050,34111010112,1759,875,884,98.9819004524887
SL050,34111010113,2595,1290,1305,98.8505747126437
SL050,34111010114,1328,665,663,100.301659125189
SL050,34111010115,4156,2089,2067,101.064344460571
SL050,34111010116,4602,2275,2327,97.7653631284916
SL050,34111010117,217,112,105,106.666666666667
SL050,34111010118,309,159,150,106
SL050,34111010119,634,314,320,98.125
SL050,34111010120,175,90,85,105.882352941176
SL050,34111010121,9685,4818,4867,98.9932196424902
SL050,34111010122,256,128,128,100
SL050,34111010123,653,327,326,100.306748466258
SL050,34111010124,827,412,415,99.2771084337349
SL050,34111010125,969,497,472,105.296610169492
SL050,34111010126,1732,875,857,102.100350058343
SL050,34111010127,5731,2918,2813,103.7326697476
SL050,34111010128,6792,3384,3408,99.2957746478873
SL050,34111010129,378,176,202,87.1287128712871
SL050,34111010130,2003,1008,995,101.306532663317
SL050,34111010131,17170,8274,8896,93.0080935251799
SL050,34111010132,416,207,209,99.0430622009569
SL050,34111010133,1336,669,667,100.299850074963
SL050,34111010134,646,330,316,104.430379746835
SL050,34111010135,1311,691,620,111.451612903226
SL050,34111010136,310,178,132,134.848484848485
SL050,34111010137,411,220,191,115.183246073298
SL050,34111010138,641,309,332,93.0722891566265
SL050,34111010139,85,47,38,123.684210526316
SL050,34111010140,1390,708,682,103.812316715543
SL050,34111010141,277,143,134,106.716417910448
SL050,34111010142,941,483,458,105.458515283843
SL050,34111010143,151,66,85,77.6470588235294
SL050,34111010144,1065,554,511,108.414872798434
SL050,34111010145,149,70,79,88.6075949367089
SL050,34111010146,1748,928,820,113.170731707317
SL050,34111010147,1530,771,759,101.581027667984
SL050,34111010148,40141,19421,20720,93.730694980695
SL050,34111010149,487,244,243,100.411522633745
SL050,34111010150,362,187,175,106.857142857143
SL050,34111010151,225,118,107,110.280373831776
SL050,34111010152,471,237,234,101.282051282051
SL050,34111010153,323,168,155,108.387096774194
SL050,34111010154,213,107,106,100.943396226415
SL050,34111010155,1248,649,599,108.347245409015
SL050,34111010156,91,49,42,116.666666666667
SL050,34111010157,272,143,129,110.852713178295
SL050,34111010158,369,186,183,101.639344262295
SL050,34111010159,315,174,141,123.404255319149
SL050,34111010160,259,127,132,96.2121212121212
SL050,34111010161,65,36,29,124.137931034483
SL050,34111010162,581,302,279,108.243727598566
SL050,34111010163,323,165,158,104.430379746835
SL050,34111010164,788,388,400,97
SL050,34111010165,249,136,113,120.353982300885
SL050,34111010166,324,161,163,98.7730061349693
SL050,34111010167,315,174,141,123.404255319149
SL050,34111010168,271,138,133,103.759398496241
SL050,34111010169,522,256,266,96.2406015037594
SL050,34111010170,259,132,127,103.937007874016
SL050,34111010171,382,205,177,115.819209039548
SL050,34111010172,763,392,371,105.660377358491
SL050,34111010173,858,452,406,111.330049261084
SL050,34111010174,187,91,96,94.7916666666667
SL050,34111010175,1568,790,778,101.542416452442
SL050,34111010176,420,220,200,110
SL050,34111010177,1996,1015,981,103.465851172273
SL050,34111010178,832,432,400,108
SL050,34111010179,306,163,143,113.986013986014
SL050,34111010180,7345,3968,3377,117.500740302043
SL050,34111010181,806,430,376,114.36170212766
SL050,34111010182,164,104,60,173.333333333333
SL050,34111010183,1143,608,535,113.644859813084
SL050,34111010184,884,463,421,109.976247030879
SL050,34111010185,622,330,292,113.013698630137
SL050,34111010186,1071,543,528,102.840909090909
SL050,34111010187,461,246,215,114.418604651163
SL050,34111010188,532,267,265,100.754716981132
SL050,34111010189,2975,1451,1524,95.2099737532808
SL050,34111010190,571,286,285,100.350877192982
SL050,34111010191,610,324,286,113.286713286713
SL050,34111010192,840,420,420,100
SL050,34111010193,1677,816,861,94.7735191637631
SL050,34111010194,570,272,298,91.2751677852349
SL050,34111010195,9193,4477,4716,94.9321458863444
SL050,34111010196,334,175,159,110.062893081761
SL050,34111010197,99,55,44,125
SL050,34111010198,1230,605,625,96.8
SL050,34111010199,178,96,82,117.073170731707
SL050,34111010200,361,188,173,108.670520231214
SL050,34111010201,197,97,100,97
SL050,34111010202,664,322,342,94.1520467836257
SL050,34111010203,5439,2662,2777,95.8588404753331
SL050,34111010204,460,233,227,102.643171806167
SL050,34111010205,2349,1183,1166,101.457975986278
SL050,34111010206,233,122,111,109.90990990991
SL050,34111010207,502,239,263,90.8745247148289
SL050,34111010208,136,69,67,102.985074626866
SL050,34111010209,260,135,125,108
SL050,34111010210,426,214,212,100.943396226415
SL050,34111010211,433,217,216,100.462962962963
SL050,34111010212,2046,1027,1019,100.785083415113
SL050,34111010213,618,317,301,105.31561461794
SL050,34111010214,234,125,109,114.678899082569
SL050,34111010215,341,170,171,99.4152046783626
SL050,34111010216,1823,917,906,101.21412803532
SL050,34111010217,550,275,275,100
SL050,34111010218,1258,629,629,100
SL050,34111010219,1377,697,680,102.5
SL050,34111010901,1362,715,647,110.510046367852
SL050,34111010902,868,446,422,105.687203791469
SL050,34111010903,934,467,467,100
SL050,34111010904,921,485,436,111.238532110092
SL050,34111010905,814,417,397,105.037783375315
SL050,34011111001,5242,2701,2541,106.296733569461
SL050,34011111002,5123,2572,2551,100.823206585653
SL050,34011111003,1413,730,683,106.88140556369
SL050,34011111004,121414,59852,61562,97.2223124654819
SL050,34011111005,5590,2842,2748,103.420669577875
SL050,34011111006,30741,15346,15395,99.6817148424813
SL050,34011111007,22551,11305,11246,100.524630979904
SL050,34011111008,23513,11745,11768,99.8045547246771
SL050,34011111009,680,364,316,115.189873417722
SL050,34011111010,7750,3882,3868,100.361944157187
SL050,34011111011,2167,1097,1070,102.523364485981
SL050,34011111012,116979,55374,61605,89.8855612369126
SL050,34011111013,3013,1506,1507,99.9336429993364
SL050,34011111014,22427,11304,11123,101.627258833049
SL050,34011111015,83831,41968,41863,100.250818144901
SL050,34011111016,19068,9564,9504,100.631313131313
SL050,34011111017,3903,1964,1939,101.289324394018
SL050,34011111018,1726,892,834,106.954436450839
SL050,34011111019,2053,1018,1035,98.3574879227053
SL050,34011111020,212879,104084,108795,95.6698377682798
SL050,34011111021,9773,5045,4728,106.704737732657
SL050,34011111022,62940,30895,32045,96.4112966141364
SL050,34011111023,11658,5934,5724,103.668763102725
SL050,34011111024,8124,3983,4141,96.1844964984303
SL050,34011111025,5530,2856,2674,106.806282722513
SL050,34011111026,5636,2815,2821,99.7873094647288
SL050,34011111027,88364,43326,45038,96.1987654869222
SL050,34011111028,41650,20922,20728,100.935932072559
SL050,34011111029,6996,3537,3459,102.25498699046
SL050,34011111030,28848,14403,14445,99.7092419522326
SL050,34011111031,95174,46602,48572,95.9441653627604
SL050,34011111032,68037,33868,34169,99.1190845503234
SL050,34011111033,30472,15209,15263,99.6462032365852
SL050,34011111034,2732,1401,1331,105.259203606311
SL050,34011111035,18169,9151,9018,101.474828121535
SL050,34011111036,804,401,403,99.5037220843672
SL050,34011111037,7054,3522,3532,99.7168742921857
SL050,34011111038,16615,8207,8408,97.6094196003806
SL050,34011111039,12739,6349,6390,99.358372456964
SL050,34011111040,438,229,209,109.569377990431
SL050,34011111041,12127,6078,6049,100.479418085634
SL050,34011111042,1400,713,687,103.784570596798
SL050,34011111901,6969,3546,3423,103.593339176161
SL050,34011111902,4402,2255,2147,105.030274802049
SL050,34101212001,1271,643,628,102.388535031847
SL050,34101212002,125,66,59,111.864406779661
SL050,34101212003,1234,615,619,99.3537964458804
SL050,34101212004,6679,3440,3239,106.205619018216
SL050,34101212005,10430,5262,5168,101.818885448916
SL050,34101212006,201,108,93,116.129032258065
SL050,34101212007,862,438,424,103.301886792453
SL050,34101212008,259,146,113,129.203539823009
SL050,34101212009,25831,12984,12847,101.066396824161
SL050,34101212010,256,141,115,122.608695652174
SL050,34101212011,5900,2958,2942,100.543847722638
SL050,34101212012,3509,1791,1718,104.249126891735
SL050,34101212013,146,72,74,97.2972972972973
SL050,34101212014,190,107,83,128.915662650602
SL050,34101212015,113,69,44,156.818181818182
SL050,34101212016,1958,992,966,102.691511387164
SL050,34101212017,164,88,76,115.789473684211
SL050,34101212018,324,172,152,113.157894736842
SL050,34101212020,169,93,76,122.368421052632
SL050,34101212021,5709,2815,2894,97.2702142363511
SL050,34101212022,373,214,159,134.591194968553
SL050,34101212024,156,82,74,110.810810810811
SL050,34101212025,149,84,65,129.230769230769
SL050,34101212026,1084,560,524,106.870229007634
SL050,34101212027,26744,13326,13418,99.3143538530332
SL050,34101212028,18055,9015,9040,99.7234513274336
SL050,34101212029,1036,524,512,102.34375
SL050,34101212031,5322,2696,2626,102.665651180503
SL050,34101212032,34544,17121,17423,98.2666590139471
SL050,34101212033,2889,1468,1421,103.307529908515
SL050,34101212034,1945,995,950,104.736842105263
SL050,34101212036,696,338,358,94.413407821229
SL050,34101212037,19,10,9,111.111111111111
SL050,34101212038,192,104,88,118.181818181818
SL050,34101212039,946,479,467,102.569593147752
SL050,34101212040,170888,82695,88193,93.7659451430386
SL050,34101212041,101,66,35,188.571428571429
SL050,34101212042,742,370,372,99.4623655913979
SL050,34101212043,647,334,313,106.709265175719
SL050,34101212044,599,292,307,95.114006514658
SL050,34101212045,399,193,206,93.6893203883495
SL050,34101212046,206,113,93,121.505376344086
SL050,34101212048,317,173,144,120.138888888889
SL050,34101212049,511,272,239,113.807531380753
SL050,34101212050,1822,914,908,100.660792951542
SL050,34101212051,504,261,243,107.407407407407
SL050,34101212052,725,344,381,90.2887139107612
SL050,34101212053,2670,1377,1293,106.496519721578
SL050,34101212055,113,66,47,140.425531914894
SL050,34101212056,297,155,142,109.154929577465
SL050,34101212057,776,397,379,104.749340369393
SL050,34101212058,72,41,31,132.258064516129
SL050,34101212059,276,139,137,101.459854014599
SL050,34101212060,525,266,259,102.702702702703
SL050,34101212061,453,223,230,96.9565217391304
SL050,34101212063,49,27,22,122.727272727273
SL050,34101212064,94,53,41,129.268292682927
SL050,34101212065,193,103,90,114.444444444444
SL050,34101212067,633,314,319,98.4326018808777
SL050,34101212068,49,27,22,122.727272727273
SL050,34101212069,62,37,25,148
SL050,34101212070,666,334,332,100.602409638554
SL050,34101212071,1553,803,750,107.066666666667
SL050,34101212072,1319,664,655,101.374045801527
SL050,34101212073,155,86,69,124.63768115942
SL050,34101212074,940,467,473,98.7315010570825
SL050,34101212075,162,85,77,110.38961038961
SL050,34101212076,84,43,41,104.878048780488
SL050,34101212077,6278,3257,3021,107.811982787157
SL050,34101212078,359,172,187,91.9786096256685
SL050,34101212079,548,286,262,109.160305343511
SL050,34101212080,2437,1197,1240,96.5322580645161
SL050,34101212081,712,373,339,110.029498525074
SL050,34101212082,13170,6584,6586,99.9696325539022
SL050,34101212083,117,65,52,125
SL050,34101212084,24850,12464,12386,100.629743258518
SL050,34101212085,8830,4544,4286,106.01959869342
SL050,34101212087,31,17,14,121.428571428571
SL050,34101212088,62,39,23,169.565217391304
SL050,34101212089,7447,3747,3700,101.27027027027
SL050,34101212090,114,59,55,107.272727272727
SL050,34101212091,197,97,100,97
SL050,34101212092,144,77,67,114.925373134328
SL050,34101212093,197,110,87,126.436781609195
SL050,34101212094,1208,628,580,108.275862068966
SL050,34101212095,1180,605,575,105.217391304348
SL050,34101212096,952,500,452,110.619469026549
SL050,34101212097,59,39,20,195
SL050,34101212098,729,366,363,100.826446280992
SL050,34101212099,935,486,449,108.240534521158
SL050,34101212100,1974,973,1001,97.2027972027972
SL050,34101212101,462,230,232,99.1379310344828
SL050,34101212102,761,407,354,114.971751412429
SL050,34101212103,101,49,52,94.2307692307692
SL050,34101212104,8878,4351,4527,96.112215595317
SL050,34101212105,1023,542,481,112.681912681913
SL050,34101212106,1439,702,737,95.2510176390773
SL050,34101212107,428,220,208,105.769230769231
SL050,34101212108,520,270,250,108
SL050,34101212109,814,408,406,100.492610837438
SL050,34101212110,249,131,118,111.016949152542
SL050,34101212111,435,220,215,102.325581395349
SL050,34101212112,138,81,57,142.105263157895
SL050,34101212113,100,54,46,117.391304347826
SL050,34101212114,229,120,109,110.091743119266
SL050,34101212115,253,138,115,120
SL050,34101212116,54,26,28,92.8571428571429
SL050,34101212117,5461,2754,2707,101.736239379387
SL050,34101212118,74,45,29,155.172413793103
SL050,34101212119,157,87,70,124.285714285714
SL050,34101212120,191,96,95,101.052631578947
SL050,34101212121,1375,692,683,101.317715959004
SL050,34101212122,966,503,463,108.639308855292
SL050,34101212123,49,23,26,88.4615384615385
SL050,34101212124,2817,1471,1346,109.286775631501
SL050,34101212125,281,140,141,99.290780141844
SL050,34101212126,31552,15577,15975,97.508607198748
SL050,34101212127,75,42,33,127.272727272727
SL050,34101212128,1833,982,851,115.393654524089
SL050,34101212129,2227,1102,1125,97.9555555555555
SL050,34101212130,462,252,210,120
SL050,34101212131,63,38,25,152
SL050,34101212132,575,298,277,107.581227436823
SL050,34101212133,66,34,32,106.25
SL050,34101212134,172,90,82,109.756097560976
SL050,34101212135,50577,25125,25452,98.7152286657237
SL050,34101212136,3226,1611,1615,99.7523219814241
SL050,34101212137,42,23,19,121.052631578947
SL050,34101212138,28438,14011,14427,97.1165176405351
SL050,34101212139,342,190,152,125
SL050,34101212140,1538,796,742,107.277628032345
SL050,34101212141,112,58,54,107.407407407407
SL050,34101212142,172,97,75,129.333333333333
SL050,34101212901,4460,2220,2240,99.1071428571429
SL050,34101212902,3099,1618,1481,109.250506414585
SL050,34081313001,1395,715,680,105.147058823529
SL050,34081313002,1687,846,841,100.594530321046
SL050,34081313003,507,260,247,105.263157894737
SL050,34081313004,1185,615,570,107.894736842105
SL050,34081313005,30686,14982,15704,95.4024452368823
SL050,34081313006,602,302,300,100.666666666667
SL050,34081313007,1455,739,716,103.212290502793
SL050,34081313008,485,247,238,103.781512605042
SL050,34081313009,1660,844,816,103.43137254902
SL050,34081313010,1000,506,494,102.429149797571
SL050,34081313011,5461,2614,2847,91.8159466104672
SL050,34081313012,417,218,199,109.547738693467
SL050,34081313013,8922,4388,4534,96.7798853109837
SL050,34081313014,526,277,249,111.244979919679
SL050,34081313015,6139,3084,3055,100.949263502455
SL050,34081313016,799,394,405,97.2839506172839
SL050,34081313017,327,164,163,100.613496932515
SL050,34081313018,1043,536,507,105.719921104537
SL050,34081313019,6901,3466,3435,100.902474526929
SL050,34081313020,5921,3000,2921,102.704553235193
SL050,34081313021,449,242,207,116.908212560386
SL050,34081313022,387,193,194,99.4845360824742
SL050,34081313023,11884,6033,5851,103.110579388139
SL050,34081313024,1000,520,480,108.333333333333
SL050,34081313025,311,168,143,117.482517482517
SL050,34081313026,487,255,232,109.913793103448
SL050,34081313027,3802,1892,1910,99.0575916230366
SL050,34081313028,13597,6780,6817,99.4572392548042
SL050,34081313029,92,56,36,155.555555555556
SL050,34081313030,139,83,56,148.214285714286
SL050,34081313031,3080,1544,1536,100.520833333333
SL050,34081313032,1225,627,598,104.849498327759
SL050,34081313033,1918,965,953,101.259181532004
SL050,34081313034,74743,35421,39322,90.079344895987
SL050,34081313035,1129,554,575,96.3478260869565
SL050,34081313036,882,468,414,113.04347826087
SL050,34081313037,973,483,490,98.5714285714286
SL050,34081313038,1831,888,943,94.1675503711559
SL050,34081313039,18051,9004,9047,99.5247043218747
SL050,34081313040,1022,504,518,97.2972972972973
SL050,34081313041,261,142,119,119.327731092437
SL050,34081313042,1031,546,485,112.577319587629
SL050,34081313043,217,112,105,106.666666666667
SL050,34081313044,3253,1677,1576,106.408629441624
SL050,34081313045,731,359,372,96.505376344086
SL050,34081313046,731,362,369,98.1029810298103
SL050,34081313047,8425,4303,4122,104.391072295002
SL050,34081313048,532,271,261,103.831417624521
SL050,34081313049,903,457,446,102.466367713004
SL050,34081313050,569,282,287,98.2578397212544
SL050,34081313051,374,202,172,117.441860465116
SL050,34081313052,8129,4021,4108,97.8821811100292
SL050,34081313053,18043,8930,9113,97.9918797322506
SL050,34081313054,6016,3028,2988,101.338688085676
SL050,34081313055,688,346,342,101.169590643275
SL050,34081313056,15316,7705,7611,101.235054526343
SL050,34081313057,1330,701,629,111.446740858506
SL050,34081313058,5279,2672,2607,102.493287303414
SL050,34081313059,219,113,106,106.603773584906
SL050,34081313060,223,123,100,123
SL050,34081313061,7385,3707,3678,100.78847199565
SL050,34081313062,654,340,314,108.28025477707
SL050,34081313063,4459,2271,2188,103.793418647166
SL050,34081313064,2571,1320,1251,105.515587529976
SL050,34081313065,3571,1825,1746,104.524627720504
SL050,34081313066,3443,1760,1683,104.575163398693
SL050,34081313067,370,198,172,115.116279069767
SL050,34081313068,1200,658,542,121.40221402214
SL050,34081313069,701,357,344,103.779069767442
SL050,34081313070,937,463,474,97.6793248945148
SL050,34081313071,47881,23165,24716,93.7247127366888
SL050,34081313072,978,539,439,122.779043280182
SL050,34081313073,577,307,270,113.703703703704
SL050,34081313074,1128,581,547,106.215722120658
SL050,34081313075,213,114,99,115.151515151515
SL050,34081313076,523,254,269,94.4237918215613
SL050,34081313077,4154,2060,2094,98.3763132760268
SL050,34081313078,12268,6184,6084,101.643655489809
SL050,34081313079,15523,7832,7691,101.833311662983
SL050,34081313080,333,176,157,112.101910828025
SL050,34081313081,697,360,337,106.824925816024
SL050,34081313082,36091,17867,18224,98.0410447761194
SL050,34081313083,2959,1479,1480,99.9324324324324
SL050,34081313084,1018,495,523,94.6462715105163
SL050,34081313085,2752,1395,1357,102.80029476787
SL050,34081313086,169,88,81,108.641975308642
SL050,34081313087,30210,14762,15448,95.559295701709
SL050,34081313088,692,324,368,88.0434782608696
SL050,34081313089,1854,895,959,93.3263816475495
SL050,34081313090,1180,572,608,94.0789473684211
SL050,34081313091,602,303,299,101.33779264214
SL050,34081313092,2123,1083,1040,104.134615384615
SL050,34081313093,5030,2477,2553,97.0231100665883
SL050,34081313094,295,159,136,116.911764705882
SL050,34081313095,86,46,40,115
SL050,34081313096,9902,4915,4987,98.5562462402246
SL050,34081313097,2845,1426,1419,100.493305144468
SL050,34081313098,2363,1144,1219,93.8474159146842
SL050,34081313901,1111,588,523,112.428298279159
SL050,34081313902,548,276,272,101.470588235294
SL050,34081313903,595,308,287,107.317073170732
SL050,34081313904,719,354,365,96.986301369863
SL050,34011414001,4185,2155,2030,106.15763546798
SL050,34011414002,13438,6738,6700,100.567164179104
SL050,34011414003,1473,713,760,93.8157894736842
SL050,34011414004,2409,1204,1205,99.9170124481328
SL050,34011414005,7964,3987,3977,100.251445813427
SL050,34011414006,1524,754,770,97.9220779220779
SL050,34011414007,19338,9868,9470,104.202745512144
SL050,34011414008,3273,1571,1702,92.3031727379554
SL050,34011414009,2964,1435,1529,93.8521909744931
SL050,34011414010,4975,2492,2483,100.362464760371
SL050,34011414011,681,351,330,106.363636363636
SL050,34011414012,7537,3752,3785,99.1281373844122
SL050,34011414013,20417,9961,10456,95.2658760520276
SL050,34011414014,2969,1526,1443,105.751905751906
SL050,34011414015,2454,1251,1203,103.990024937656
SL050,34011414016,1503,744,759,98.0237154150198
SL050,34011414017,14067,7026,7041,99.7869620792501
SL050,34011414018,4457,2204,2253,97.8251220594763
SL050,34011414019,7834,3889,3945,98.5804816223067
SL050,34011414020,401,196,205,95.609756097561
SL050,34011414021,325708,156417,169291,92.3953429302208
SL050,34011414022,4684,2282,2402,95.0041631973356
SL050,34011414023,2416,1199,1217,98.5209531635169
SL050,34011414024,2285,1130,1155,97.8354978354978
SL050,34011414025,3333,1673,1660,100.78313253012
SL050,34011414026,2438,1227,1211,101.321222130471
SL050,34011414027,9668,4856,4812,100.914380714879
SL050,34011414028,350,183,167,109.580838323353
SL050,34011414029,4651,2398,2253,106.435863293387
SL050,34011414030,10817,5425,5392,100.612017804154
SL050,34011414031,680,327,353,92.6345609065156
SL050,34011414032,456,233,223,104.484304932735
SL050,34011414033,1578,788,790,99.746835443038
SL050,34011414034,353,182,171,106.432748538012
SL050,34011414035,6868,3365,3503,96.0605195546674
SL050,34011414036,4541,2266,2275,99.6043956043956
SL050,34011414037,4343,2175,2168,100.322878228782
SL050,34011414038,42530,21212,21318,99.5027676142227
SL050,34011414039,3037,1532,1505,101.794019933555
SL050,34011414040,4429,2202,2227,98.8774135608442
SL050,34011414041,3874,1947,1927,101.037882719253
SL050,34011414042,23031,11423,11608,98.4062715368711
SL050,34011414043,9436,4641,4795,96.7883211678832
SL050,34011414044,1964,976,988,98.7854251012146
SL050,34011414045,3726,1870,1856,100.754310344828
SL050,34011414046,5393,2733,2660,102.744360902256
SL050,34011414047,1990,1043,947,110.137275607181
SL050,34011414048,1481,743,738,100.677506775068
SL050,34011414049,21159,10540,10619,99.2560504755627
SL050,34011414050,2834,1434,1400,102.428571428571
SL050,34011414051,1529,738,791,93.2996207332491
SL050,34011414052,10870,5245,5625,93.2444444444444
SL050,34011414053,7343,3648,3695,98.7280108254398
SL050,34011414054,17222,8382,8840,94.8190045248869
SL050,34011414055,22585,11008,11577,95.0850824911462
SL050,34011414056,30241,15058,15183,99.1767107949681
SL050,34011414057,7508,3731,3777,98.7821021975113
SL050,34011414058,9857,4906,4951,99.0910927085437
SL050,34011414059,814,404,410,98.5365853658537
SL050,34011414060,6014,3039,2975,102.151260504202
SL050,34011414061,768,384,384,100
SL050,34011414062,1063,517,546,94.6886446886447
SL050,34011414063,1157,578,579,99.8272884283247
SL050,34011414064,368,178,190,93.6842105263158
SL050,34011414065,2284,1138,1146,99.3019197207679
SL050,34011414066,7200,3603,3597,100.166805671393
SL050,34011414067,4861,2481,2380,104.243697478992
SL050,34011414068,643,314,329,95.4407294832827
SL050,34011414069,8774,4340,4434,97.8800180423996
SL050,34011414070,1494,753,741,101.619433198381
SL050,34011414071,1068,520,548,94.8905109489051
SL050,34011414072,1154,577,577,100
SL050,34011414073,3298,1700,1598,106.382978723404
SL050,34011414074,2568,1278,1290,99.0697674418605
SL050,34011414075,641,326,315,103.492063492063
SL050,34121515001,5454,2684,2770,96.8953068592058
SL050,34121515002,31278,15015,16263,92.326139088729
SL050,34121515003,1894,984,910,108.131868131868
SL050,34121515004,5671,2798,2873,97.3894883397146
SL050,34121515005,31917,15853,16064,98.6865039840637
SL050,34121515006,6053,3010,3043,98.9155438711798
SL050,34121515007,3505,1659,1846,89.8699891657638
SL050,34121515008,6602,3222,3380,95.3254437869822
SL050,34121515009,12916,6131,6785,90.3610906411201
SL050,34121515010,2022,1026,996,103.012048192771
SL050,34121515011,18844,9191,9653,95.2139231327049
SL050,34121515012,4215,2069,2146,96.4119291705499
SL050,34121515013,7748,3727,4021,92.6883859736384
SL050,34121515014,4337,2091,2246,93.0988423864648
SL050,34121515015,3318,1628,1690,96.3313609467456
SL050,34121515016,5322,2605,2717,95.8778064041222
SL050,34121515017,24603,12027,12576,95.6345419847328
SL050,34121515018,1238,617,621,99.3558776167472
SL050,34121515019,31261,15299,15962,95.8463851647663
SL050,34121515020,4031,1915,2116,90.5009451795841
SL050,34121515021,6294,3096,3198,96.8105065666041
SL050,34121515022,6794,3373,3421,98.5969014907922
SL050,34121515023,7576,3627,3949,91.8460369713852
SL050,34121515024,5023,2478,2545,97.3673870333988
SL050,34121515025,1126,551,575,95.8260869565217
SL050,34121515027,1824,896,928,96.551724137931
SL050,34121515028,1578,764,814,93.8574938574939
SL050,34121515029,6177,2955,3222,91.7132216014898
SL050,34121515030,244850,113613,131237,86.5708603518825
SL050,34121515031,30221,14586,15635,93.2906939558683
SL050,34121515032,3958,1979,1979,100
SL050,34121515033,2791,1357,1434,94.6304044630404
SL050,34121515034,3040,1467,1573,93.2612841703751
SL050,34121515035,13013,6214,6799,91.395793499044
SL050,34121515036,66799,31319,35480,88.2722660653889
SL050,34121515037,4701,2375,2326,102.106620808255
SL050,34121515038,2385,1182,1203,98.2543640897756
SL050,34121515039,1333,664,669,99.2526158445441
SL050,34121515040,3084,1543,1541,100.129785853342
SL050,34121515041,11302,5564,5738,96.9675845242245
SL050,34121515042,3386,1658,1728,95.9490740740741
SL050,34121515043,5447,2646,2801,94.4662620492681
SL050,34121515044,1363,670,693,96.6810966810967
SL050,34121515045,3947,1887,2060,91.6019417475728
SL050,34121515046,7443,3659,3784,96.6966173361522
SL050,34121515047,2582,1271,1311,96.9488939740656
SL050,34121515048,6056,3024,3032,99.7361477572559
SL050,34121515049,1226,576,650,88.6153846153846
SL050,34121515050,1962,1014,948,106.962025316456
SL050,34121515051,5307,2582,2725,94.7522935779816
SL050,34121515052,4736,2297,2439,94.1779417794178
SL050,34121515053,8695,4205,4490,93.652561247216
SL050,34121515054,39115,18891,20224,93.4088212025316
SL050,34121515055,5112,2478,2634,94.0774487471526
SL050,34121515056,6877,3325,3552,93.6092342342342
SL050,34121515057,14271,6839,7432,92.0209903121636
SL050,34121515058,35559,17193,18366,93.6131983012088
SL050,34121515059,12632,6157,6475,95.0888030888031
SL050,34121515060,7452,3700,3752,98.6140724946695
SL050,34121515061,5804,2773,3031,91.487957769713
SL050,34121515062,6412,3081,3331,92.4947463224257
SL050,34121515064,2419,1179,1240,95.0806451612903
SL050,34121515065,8386,4025,4361,92.2953451043339
SL050,34121515066,4656,2333,2323,100.430477830392
SL050,34121515067,9390,4568,4822,94.7324761509747
SL050,34121515068,5565,2794,2771,100.830025261638
SL050,34121515069,7884,3775,4109,91.8715015818934
SL050,34121515070,10237,4999,5238,95.4371897670867
SL050,34121515071,9243,4596,4647,98.9025177533893
SL050,34121515072,11104,5421,5683,95.3897589301425
SL050,34121515073,27067,13355,13712,97.3964410735123
SL050,34121515074,4564,2177,2387,91.2023460410557
SL050,34121515075,15495,7574,7921,95.6192399949501
SL050,34121515076,2828,1401,1427,98.1779957953749
SL050,34121515077,9450,4576,4874,93.8859253180139
SL050,34121515078,96405,44780,51625,86.7409200968523
SL050,34121515079,1610,825,785,105.095541401274
SL050,34121515080,1799,927,872,106.307339449541
SL050,34121515081,1103,553,550,100.545454545455
SL050,34121515082,18525,9115,9410,96.865037194474
SL050,34121515083,1151,599,552,108.514492753623
SL050,34121515084,3361,1581,1780,88.8202247191011
SL050,34121515085,3620,1806,1814,99.5589856670342
SL050,34121515086,3148,1551,1597,97.1195992485911
SL050,34121515087,6613,3209,3404,94.2714453584019
SL050,34121515088,3925,1884,2041,92.3076923076923
SL050,34121515089,5046,2485,2561,97.0324092151503
SL050,34121515090,1225,645,580,111.206896551724
SL050,34121515091,1231,629,602,104.485049833887
SL050,34121515092,7138,3421,3717,92.0365886467581
SL050,34121515093,4581,2219,2362,93.9458086367485
SL050,34121515901,3945,1959,1986,98.6404833836858
SL050,34121515902,5155,2596,2559,101.445877295819
SL050,34081616001,64,39,25,156
SL050,34081616002,234,116,118,98.3050847457627
SL050,34081616003,153,70,83,84.3373493975904
SL050,34081616004,252,134,118,113.559322033898
SL050,34081616005,268,142,126,112.698412698413
SL050,34081616006,125,58,67,86.5671641791045
SL050,34081616007,1590,802,788,101.776649746193
SL050,34081616008,90,50,40,125
SL050,34081616009,56,32,24,133.333333333333
SL050,34081616010,137,65,72,90.2777777777778
SL050,34081616011,30,16,14,114.285714285714
SL050,34081616012,90,52,38,136.842105263158
SL050,34081616013,25,14,11,127.272727272727
SL050,34081616014,659,342,317,107.88643533123
SL050,34081616015,375,208,167,124.550898203593
SL050,34081616016,225,131,94,139.36170212766
SL050,34081616017,390,212,178,119.101123595506
SL050,34081616018,431,221,210,105.238095238095
SL050,34081616019,195,104,91,114.285714285714
SL050,34081616020,10,5,5,100
SL050,34081616022,85,49,36,136.111111111111
SL050,34081616023,602,316,286,110.48951048951
SL050,34081616024,147,81,66,122.727272727273
SL050,34081616025,26,14,12,116.666666666667
SL050,34081616026,95,48,47,102.127659574468
SL050,34081616027,903,482,421,114.489311163895
SL050,34081616029,87,54,33,163.636363636364
SL050,34081616030,19,14,5,280
SL050,34081616031,35,19,16,118.75
SL050,34081616032,328,169,159,106.289308176101
SL050,34081616033,1938,972,966,100.621118012422
SL050,34081616034,165,95,70,135.714285714286
SL050,34081616035,279,133,146,91.0958904109589
SL050,34081616036,144,69,75,92
SL050,34081616038,40,26,14,185.714285714286
SL050,34081616039,446,235,211,111.374407582938
SL050,34081616040,90,53,37,143.243243243243
SL050,34081616041,414,221,193,114.507772020725
SL050,34081616042,1344,665,679,97.9381443298969
SL050,34081616043,113,63,50,126
SL050,34081616044,40,19,21,90.4761904761905
SL050,34081616045,219,121,98,123.469387755102
SL050,34081616046,247,126,121,104.132231404959
SL050,34081616047,252,134,118,113.559322033898
SL050,34081616048,467,255,212,120.283018867925
SL050,34081616049,151,80,71,112.676056338028
SL050,34081616050,267,134,133,100.751879699248
SL050,34081616051,138,71,67,105.970149253731
SL050,34081616052,769,395,374,105.614973262032
SL050,34081616053,456,251,205,122.439024390244
SL050,34081616055,785,404,381,106.036745406824
SL050,34081616056,495,265,230,115.217391304348
SL050,34081616057,75,45,30,150
SL050,34081616058,111,57,54,105.555555555556
SL050,34081616060,877,427,450,94.8888888888889
SL050,34081616061,1210,637,573,111.169284467714
SL050,34081616062,27,18,9,200
SL050,34081616063,111,59,52,113.461538461538
SL050,34081616064,836,441,395,111.645569620253
SL050,34081616065,459,229,230,99.5652173913043
SL050,34081616066,3072,1604,1468,109.264305177112
SL050,34081616067,155,79,76,103.947368421053
SL050,34081616068,150,82,68,120.588235294118
SL050,34081616070,30,16,14,114.285714285714
SL050,34081616071,21,10,11,90.9090909090909
SL050,34081616072,139,80,59,135.593220338983
SL050,34081616073,216,111,105,105.714285714286
SL050,34081616074,30,17,13,130.769230769231
SL050,34081616078,54898,26154,28744,90.9894238797662
SL050,34081616079,29,21,8,262.5
SL050,34081616081,57,33,24,137.5
SL050,34081616082,321,170,151,112.582781456954
SL050,34081616083,49,25,24,104.166666666667
SL050,34081616084,48,27,21,128.571428571429
SL050,34081616085,169,90,79,113.924050632911
SL050,34081616086,1212,629,583,107.890222984563
SL050,34081616087,248,130,118,110.169491525424
SL050,34081616088,105,56,49,114.285714285714
SL050,34081616089,454,239,215,111.162790697674
SL050,34081616091,70,39,31,125.806451612903
SL050,34081616092,183,106,77,137.662337662338
SL050,34081616093,68,37,31,119.354838709677
SL050,34081616094,154,84,70,120
SL050,34081616095,93,52,41,126.829268292683
SL050,34081616096,365,193,172,112.209302325581
SL050,34081616097,145,73,72,101.388888888889
SL050,34081616098,678,346,332,104.21686746988
SL050,34081616099,195,98,97,101.030927835052
SL050,34081616100,789,386,403,95.7816377171216
SL050,34081616101,142,78,64,121.875
SL050,34081616102,1597,800,797,100.376411543287
SL050,34081616103,263,142,121,117.355371900826
SL050,34081616104,53,29,24,120.833333333333
SL050,34081616106,3526,1789,1737,102.993667242372
SL050,34081616107,98,57,41,139.024390243902
SL050,34081616108,51,27,24,112.5
SL050,34081616109,52,29,23,126.086956521739
SL050,34081616110,124,72,52,138.461538461538
SL050,34081616111,190,108,82,131.707317073171
SL050,34081616112,1777,919,858,107.109557109557
SL050,34081616113,4299,2131,2168,98.2933579335793
SL050,34081616115,45,26,19,136.842105263158
SL050,34081616116,65,39,26,150
SL050,34081616117,1216,613,603,101.658374792703
SL050,34081616118,1584,782,802,97.5062344139651
SL050,34081616119,189,95,94,101.063829787234
SL050,34081616121,251,130,121,107.438016528926
SL050,34081616122,293,150,143,104.895104895105
SL050,34081616123,70,41,29,141.379310344828
SL050,34081616124,2328,1178,1150,102.434782608696
SL050,34081616125,2211,1130,1081,104.532839962997
SL050,34081616126,926,459,467,98.2869379014989
SL050,34081616128,67,36,31,116.129032258065
SL050,34081616129,106,54,52,103.846153846154
SL050,34081616130,626,334,292,114.383561643836
SL050,34081616131,110,64,46,139.130434782609
SL050,34081616132,36,23,13,176.923076923077
SL050,34081616133,6030,2995,3035,98.6820428336079
SL050,34081616134,5959,2972,2987,99.4978239035822
SL050,34081616135,138,78,60,130
SL050,34081616137,43,21,22,95.4545454545455
SL050,34081616139,334,176,158,111.392405063291
SL050,34081616140,21,11,10,110
SL050,34081616141,133,68,65,104.615384615385
SL050,34081616142,151,87,64,135.9375
SL050,34081616143,15,11,4,275
SL050,34081616145,485,249,236,105.508474576271
SL050,34081616146,81,41,40,102.5
SL050,34081616147,67,41,26,157.692307692308
SL050,34081616148,625,323,302,106.953642384106
SL050,34081616149,159,81,78,103.846153846154
SL050,34081616150,101,53,48,110.416666666667
SL050,34081616151,58,33,25,132
SL050,34081616152,34,22,12,183.333333333333
SL050,34081616153,1127,569,558,101.971326164875
SL050,34081616154,6548,3345,3203,104.433343740244
SL050,34081616155,611,334,277,120.57761732852
SL050,34081616156,96,57,39,146.153846153846
SL050,34081616157,215,118,97,121.649484536082
SL050,34081616158,679,337,342,98.5380116959064
SL050,34081616159,213,105,108,97.2222222222222
SL050,34081616160,59,35,24,145.833333333333
SL050,34081616161,53,29,24,120.833333333333
SL050,34081616162,27,13,14,92.8571428571429
SL050,34081616163,64,35,29,120.689655172414
SL050,34081616165,60,31,29,106.896551724138
SL050,34081616166,290,156,134,116.417910447761
SL050,34081616167,305,144,161,89.4409937888199
SL050,34081616169,51,33,18,183.333333333333
SL050,34081616170,920,469,451,103.991130820399
SL050,34081616171,2418,1195,1223,97.7105478331971
SL050,34081616172,345,181,164,110.365853658537
SL050,34081616173,216,121,95,127.368421052632
SL050,34081616174,183,103,80,128.75
SL050,34081616175,7589,3914,3675,106.503401360544
SL050,34081616176,46,26,20,130
SL050,34081616177,118,62,56,110.714285714286
SL050,34081616181,67,31,36,86.1111111111111
SL050,34081616185,38,28,10,280
SL050,34081616186,505,260,245,106.122448979592
SL050,34081616187,81,48,33,145.454545454545
SL050,34081616188,100,58,42,138.095238095238
SL050,34081616189,296,158,138,114.492753623188
SL050,34081616190,7107,3586,3521,101.846066458393
SL050,34081616191,1040,522,518,100.772200772201
SL050,34081616192,46,24,22,109.090909090909
SL050,34081616193,55,32,23,139.130434782609
SL050,34081616194,227,122,105,116.190476190476
SL050,34081616195,590,289,301,96.0132890365448
SL050,34081616196,688,357,331,107.85498489426
SL050,34081616197,68,41,27,151.851851851852
SL050,34081616198,1643,831,812,102.339901477833
SL050,34081616199,23,11,12,91.6666666666667
SL050,34081616202,884,470,414,113.526570048309
SL050,34081616203,14990,7425,7565,98.1493721083939
SL050,34081616204,280,148,132,112.121212121212
SL050,34081616205,124,61,63,96.8253968253968
SL050,34081616206,195,103,92,111.95652173913
SL050,34081616209,114,69,45,153.333333333333
SL050,34081616211,363,187,176,106.25
SL050,34081616212,257,126,131,96.1832061068702
SL050,34081616213,39,24,15,160
SL050,34081616215,259,143,116,123.275862068966
SL050,34081616216,302,160,142,112.676056338028
SL050,34081616217,96,53,43,123.255813953488
SL050,34081616218,223,117,106,110.377358490566
SL050,34081616219,89,46,43,106.976744186047
SL050,34081616224,88,49,39,125.641025641026
SL050,34081616225,66,41,25,164
SL050,34081616227,113,67,46,145.652173913043
SL050,34081616228,203,125,78,160.25641025641
SL050,34081616231,48,27,21,128.571428571429
SL050,34081616234,28,16,12,133.333333333333
SL050,34081616236,1071,537,534,100.561797752809
SL050,34081616237,102,54,48,112.5
SL050,34081616238,501,257,244,105.327868852459
SL050,34081616239,134,85,49,173.469387755102
SL050,34081616240,100,57,43,132.558139534884
SL050,34081616242,348,172,176,97.7272727272727
SL050,34081616243,470,241,229,105.240174672489
SL050,34081616244,745,380,365,104.109589041096
SL050,34081616245,476,232,244,95.0819672131148
SL050,34081616246,515,285,230,123.913043478261
SL050,34081616247,76,39,37,105.405405405405
SL050,34081616248,1016,504,512,98.4375
SL050,34081616249,2522,1281,1241,103.223207091056
SL050,34081616250,70,43,27,159.259259259259
SL050,34081616251,2304,1164,1140,102.105263157895
SL050,34081616253,378,202,176,114.772727272727
SL050,34081616254,229,113,116,97.4137931034483
SL050,34081616255,165,88,77,114.285714285714
SL050,34081616258,189,101,88,114.772727272727
SL050,34081616259,47,27,20,135
SL050,34081616263,1258,673,585,115.042735042735
SL050,34081616264,454,232,222,104.504504504505
SL050,34081616265,21,9,12,75
SL050,34081616266,385,191,194,98.4536082474227
SL050,34081616269,466,231,235,98.2978723404255
SL050,34081616270,196,104,92,113.04347826087
SL050,34081616271,821,408,413,98.7893462469734
SL050,34081616272,233,139,94,147.872340425532
SL050,34081616273,337,179,158,113.291139240506
SL050,34081616274,128,67,61,109.836065573771
SL050,34081616275,10,6,4,150
SL050,34081616276,22,14,8,175
SL050,34081616277,124,67,57,117.543859649123
SL050,34081616278,64,32,32,100
SL050,34081616279,229,129,100,129
SL050,34081616280,181,96,85,112.941176470588
SL050,34081616901,767,380,387,98.1912144702842
SL050,34081616902,130,74,56,132.142857142857
SL050,34081616903,1516,801,715,112.027972027972
SL050,34081616904,525,275,250,110
SL050,34081616905,1665,847,818,103.545232273839
SL050,34081616906,75,48,27,177.777777777778
SL050,34081616908,188,89,99,89.8989898989899
SL050,34081616909,756,389,367,105.994550408719
SL050,34081616910,82,47,35,134.285714285714
SL050,34091717001,841,418,423,98.8179669030733
SL050,34091717002,767,388,379,102.374670184697
SL050,34091717003,139,72,67,107.462686567164
SL050,34091717004,765,396,369,107.317073170732
SL050,34091717005,576,287,289,99.3079584775086
SL050,34091717006,1559,809,750,107.866666666667
SL050,34091717007,2256,1106,1150,96.1739130434783
SL050,34091717008,5519,2735,2784,98.2399425287356
SL050,34091717009,6515,3378,3137,107.68249920306
SL050,34091717010,423,219,204,107.352941176471
SL050,34091717011,937,468,469,99.7867803837953
SL050,34091717012,1604,803,801,100.249687890137
SL050,34091717013,3934,1972,1962,100.509683995923
SL050,34091717014,85,46,39,117.948717948718
SL050,34091717015,19615,9741,9874,98.6530281547498
SL050,34091717016,1000,521,479,108.768267223382
SL050,34091717018,671,328,343,95.6268221574344
SL050,34091717019,2467,1161,1306,88.8973966309342
SL050,34091717020,4941,2493,2448,101.838235294118
SL050,34091717021,187,101,86,117.441860465116
SL050,34091717022,10859,5407,5452,99.1746148202494
SL050,34091717023,38790,19272,19518,98.7396249615739
SL050,34091717024,383,200,183,109.289617486339
SL050,34091717025,1701,851,850,100.117647058824
SL050,34091717026,702,369,333,110.810810810811
SL050,34091717027,3733,1855,1878,98.7752928647497
SL050,34091717028,369,185,184,100.54347826087
SL050,34091717029,269,139,130,106.923076923077
SL050,34091717030,944,502,442,113.574660633484
SL050,34091717031,273,153,120,127.5
SL050,34091717032,2752,1344,1408,95.4545454545455
SL050,34091717033,7458,3716,3742,99.3051843933725
SL050,34091717034,10897,5457,5440,100.3125
SL050,34091717035,690,347,343,101.166180758017
SL050,34091717036,3204,1556,1648,94.4174757281553
SL050,34091717037,133,70,63,111.111111111111
SL050,34091717038,535,263,272,96.6911764705882
SL050,34091717039,2261,1111,1150,96.6086956521739
SL050,34091717040,708,364,344,105.813953488372
SL050,34091717041,313,155,158,98.1012658227848
SL050,34091717042,613,308,305,100.983606557377
SL050,34091717043,186,103,83,124.096385542169
SL050,34091717044,10359,5285,5074,104.158454867954
SL050,34091717046,956,486,470,103.404255319149
SL050,34091717047,10820,5495,5325,103.192488262911
SL050,34091717048,10585,5215,5370,97.1135940409683
SL050,34091717049,5390,2708,2682,100.969425801641
SL050,34091717050,948,487,461,105.639913232104
SL050,34091717051,300,148,152,97.3684210526316
SL050,34091717052,162,77,85,90.5882352941177
SL050,34091717054,465,235,230,102.173913043478
SL050,34091717055,176,88,88,100
SL050,34091717056,2322,1182,1140,103.684210526316
SL050,34091717057,1253,642,611,105.073649754501
SL050,34091717058,251,130,121,107.438016528926
SL050,34091717060,557,276,281,98.220640569395
SL050,34091717061,227,122,105,116.190476190476
SL050,34091717062,10417,5308,5109,103.895087101194
SL050,34091717063,206,106,100,106
SL050,34091717064,425,210,215,97.6744186046512
SL050,34091717065,433,222,211,105.21327014218
SL050,34091717066,46381,22917,23464,97.6687691783157
SL050,34091717067,1081,525,556,94.4244604316547
SL050,34091717068,305,159,146,108.904109589041
SL050,34091717069,455,231,224,103.125
SL050,34091717070,138,76,62,122.58064516129
SL050,34091717071,1474,733,741,98.9203778677463
SL050,34091717073,2649,1316,1333,98.7246811702926
SL050,34091717074,732,362,370,97.8378378378378
SL050,34091717075,439,226,213,106.103286384977
SL050,34091717076,175,94,81,116.049382716049
SL050,34091717077,840,416,424,98.1132075471698
SL050,34091717078,429,213,216,98.6111111111111
SL050,34091717079,100266,48030,52236,91.9480817826786
SL050,34091717080,186,94,92,102.173913043478
SL050,34091717081,392,220,172,127.906976744186
SL050,34091717082,529,278,251,110.756972111554
SL050,34091717083,4139,2096,2043,102.594224180127
SL050,34091717084,278,159,119,133.613445378151
SL050,34091717085,390,206,184,111.95652173913
SL050,34091717086,3233,1620,1613,100.433973961562
SL050,34091717087,335,180,155,116.129032258065
SL050,34091717088,787,386,401,96.2593516209476
SL050,34091717089,8297,4240,4057,104.510722208528
SL050,34091717090,693,353,340,103.823529411765
SL050,34091717091,514,267,247,108.097165991903
SL050,34091717092,4868,2412,2456,98.2084690553746
SL050,34091717093,1239,617,622,99.1961414790997
SL050,34091717094,1428,764,664,115.060240963855
SL050,34091717095,37350,19099,18251,104.646320749548
SL050,34091717096,219,122,97,125.773195876289
SL050,34091717097,282,136,146,93.1506849315068
SL050,34091717098,413,217,196,110.714285714286
SL050,34091717099,98,58,40,145
SL050,34091717100,272,140,132,106.060606060606
SL050,34091717101,730,394,336,117.261904761905
SL050,34091717102,681,336,345,97.3913043478261
SL050,34091717103,6919,3561,3358,106.045265038714
SL050,34091717105,312,159,153,103.921568627451
SL050,34091717106,190,98,92,106.521739130435
SL050,34091717107,328,159,169,94.0828402366864
SL050,34091717109,899,475,424,112.028301886792
SL050,34091717110,1691,858,833,103.001200480192
SL050,34091717111,1313,647,666,97.1471471471472
SL050,34091717112,226,129,97,132.989690721649
SL050,34091717114,34486,17139,17347,98.800945408428
SL050,34091717115,382,202,180,112.222222222222
SL050,34091717116,416,217,199,109.045226130653
SL050,34091717117,22860,11322,11538,98.1279251170047
SL050,34091717118,17898,8742,9156,95.478374836173
SL050,34091717119,95,56,39,143.589743589744
SL050,34091717120,1439,718,721,99.5839112343967
SL050,34091717121,295,160,135,118.518518518519
SL050,34091717123,467,229,238,96.218487394958
SL050,34091717124,2461,1246,1215,102.551440329218
SL050,34091717125,162,90,72,125
SL050,34091717126,394,200,194,103.092783505155
SL050,34091717128,547,278,269,103.345724907063
SL050,34091717129,195,101,94,107.446808510638
SL050,34091717130,447,216,231,93.5064935064935
SL050,34091717132,1868,916,952,96.218487394958
SL050,34091717133,1660,843,817,103.182374541004
SL050,34091717134,303,170,133,127.81954887218
SL050,34091717135,530,265,265,100
SL050,34091717136,247,135,112,120.535714285714
SL050,34091717137,4595,2281,2314,98.5738980121003
SL050,34091717138,1077,525,552,95.1086956521739
SL050,34091717139,1763,873,890,98.0898876404494
SL050,34091717140,980,502,478,105.020920502092
SL050,34091717141,8981,4475,4506,99.312028406569
SL050,34091717142,3640,1825,1815,100.550964187328
SL050,34091717143,179,90,89,101.123595505618
SL050,34091717144,276,142,134,105.970149253731
SL050,34091717145,1766,879,887,99.098083427283
SL050,34091717146,4002,2060,1942,106.076210092688
SL050,34091717147,10632,5251,5381,97.5840921761754
SL050,34091717148,2181,1125,1056,106.534090909091
SL050,34091717149,462,224,238,94.1176470588235
SL050,34091717150,2059,1053,1006,104.671968190855
SL050,34091717151,263,132,131,100.763358778626
SL050,34091717152,19319,9713,9606,101.113887153862
SL050,34091717153,269,135,134,100.746268656716
SL050,34091717154,151,76,75,101.333333333333
SL050,34091717155,30622,16048,14574,110.113901468368
SL050,34091717157,156,82,74,110.810810810811
SL050,34091717158,635,368,267,137.827715355805
SL050,34091717159,804,419,385,108.831168831169
SL050,34091717160,21824,10761,11063,97.2701798788755
SL050,34091717161,1343,648,695,93.2374100719424
SL050,34091717162,245,125,120,104.166666666667
SL050,34091717163,3740,1916,1824,105.043859649123
SL050,34091717164,5591,2818,2773,101.622791200865
SL050,34091717165,840,406,434,93.5483870967742
SL050,34091717166,731,359,372,96.505376344086
SL050,34091717167,3224,1606,1618,99.2583436341162
SL050,34091717168,502,241,261,92.3371647509579
SL050,34091717169,3461,1749,1712,102.161214953271
SL050,34091717170,212,115,97,118.556701030928
SL050,34091717171,251,131,120,109.166666666667
SL050,34091717172,626,324,302,107.284768211921
SL050,34091717173,249,127,122,104.098360655738
SL050,34091717174,228,120,108,111.111111111111
SL050,34091717175,746,395,351,112.535612535613
SL050,34091717176,177,93,84,110.714285714286
SL050,34091717177,707,349,358,97.4860335195531
SL050,34091717178,2039,1088,951,114.405888538381
SL050,34091717180,12894,6490,6404,101.342910680824
SL050,34091717181,5203,2608,2595,100.500963391137
SL050,34091717182,363,191,172,111.046511627907
SL050,34091717183,351,186,165,112.727272727273
SL050,34091717184,1573,794,779,101.925545571245
SL050,34091717185,2966,1506,1460,103.150684931507
SL050,34091717186,5114,2513,2601,96.6166858900423
SL050,34091717187,848,419,429,97.6689976689977
SL050,34091717188,187,106,81,130.864197530864
SL050,34091717189,1976,981,995,98.5929648241206
SL050,34091717190,1108,570,538,105.947955390335
SL050,34091717191,210,117,93,125.806451612903
SL050,34091717192,168,89,79,112.658227848101
SL050,34091717193,5969,3023,2946,102.613713509844
SL050,34091717194,97,56,41,136.585365853659
SL050,34091717195,459,234,225,104
SL050,34091717196,314,149,165,90.3030303030303
SL050,34091717197,165,90,75,120
SL050,34091717198,723,365,358,101.95530726257
SL050,34091717199,11537,5842,5695,102.581211589113
SL050,34091717200,801,390,411,94.8905109489051
SL050,34091717201,165,100,65,153.846153846154
SL050,34091717202,5584,2816,2768,101.734104046243
SL050,34091717203,214,117,97,120.618556701031
SL050,34091717204,1139,625,514,121.5953307393
SL050,34091717205,286,141,145,97.2413793103448
SL050,34091717206,178,84,94,89.3617021276596
SL050,34091717207,3029,1528,1501,101.798800799467
SL050,34091717208,1286,651,635,102.51968503937
SL050,34091717209,912,454,458,99.1266375545852
SL050,34091717210,854,432,422,102.369668246446
SL050,34091717211,1189,582,607,95.8813838550247
SL050,34091717212,173,88,85,103.529411764706
SL050,34091717213,7740,3995,3745,106.675567423231
SL050,34091717214,951,486,465,104.516129032258
SL050,34091717215,2789,1383,1406,98.3641536273115
SL050,34091717216,204,108,96,112.5
SL050,34091717217,466,246,220,111.818181818182
SL050,34091717218,823,432,391,110.485933503836
SL050,34091717220,1026,505,521,96.9289827255278
SL050,34091717221,5443,2658,2785,95.4398563734291
SL050,34091717222,147,77,70,110
SL050,34091717223,1112,552,560,98.5714285714286
SL050,34091717224,404,211,193,109.326424870466
SL050,34091717225,312,167,145,115.172413793103
SL050,34091717226,1157,581,576,100.868055555556
SL050,34091717227,208,116,92,126.086956521739
SL050,34091717228,399,198,201,98.5074626865672
SL050,34091717230,709,348,361,96.398891966759
SL050,34091717232,205,109,96,113.541666666667
SL050,34091717233,3196,1660,1536,108.072916666667
SL050,34091717234,238,120,118,101.694915254237
SL050,34091717901,1274,639,635,100.629921259843
SL050,34091717902,1713,843,870,96.8965517241379
SL050,34091717903,1275,656,619,105.977382875606
SL050,34011818001,288,141,147,95.9183673469388
SL050,34011818002,599,307,292,105.13698630137
SL050,34011818003,18746,9329,9417,99.0655198046087
SL050,34011818004,729,403,326,123.61963190184
SL050,34011818005,415,214,201,106.467661691542
SL050,34011818006,7128,3879,3249,119.390581717452
SL050,34011818007,830,419,411,101.946472019465
SL050,34011818010,628,331,297,111.447811447811
SL050,34011818011,5378,2735,2643,103.480892924707
SL050,34011818012,2591,1333,1258,105.961844197138
SL050,34011818013,5980,3201,2779,115.185318459878
SL050,34011818014,9168,4630,4538,102.027324812693
SL050,34011818015,475,235,240,97.9166666666667
SL050,34011818016,346,186,160,116.25
SL050,34011818017,26377,13032,13345,97.6545522667666
SL050,34011818018,624,311,313,99.3610223642172
SL050,34011818020,1178,613,565,108.495575221239
SL050,34011818021,23968,11936,12032,99.2021276595745
SL050,34011818022,18554,9254,9300,99.505376344086
SL050,34011818023,20519,10210,10309,99.0396740711999
SL050,34011818024,985,518,467,110.920770877944
SL050,34011818025,340,171,169,101.183431952663
SL050,34011818027,3285,1636,1649,99.2116434202547
SL050,34011818028,1065,551,514,107.198443579767
SL050,34011818029,2297,1155,1142,101.138353765324
SL050,34011818030,719,387,332,116.566265060241
SL050,34011818032,302,158,144,109.722222222222
SL050,34011818033,279,146,133,109.774436090226
SL050,34011818034,578,292,286,102.097902097902
SL050,34011818035,1469,768,701,109.557774607703
SL050,34011818036,5070,2445,2625,93.1428571428571
SL050,34011818037,609,305,304,100.328947368421
SL050,34011818038,1253,643,610,105.409836065574
SL050,34011818039,4060,2085,1975,105.569620253165
SL050,34011818040,343,184,159,115.723270440252
SL050,34011818042,558,278,280,99.2857142857143
SL050,34011818043,178,96,82,117.073170731707
SL050,34011818044,244,144,100,144
SL050,34011818045,1337,692,645,107.286821705426
SL050,34011818046,2124,1098,1026,107.017543859649
SL050,34011818047,7928,3969,3959,100.252589037636
SL050,34011818048,3243,1657,1586,104.476670870113
SL050,34011818049,656,362,294,123.12925170068
SL050,34011818050,2044,1018,1026,99.2202729044834
SL050,34011818051,1350,706,644,109.627329192547
SL050,34011818053,1901,945,956,98.8493723849372
SL050,34011818054,993,526,467,112.633832976445
SL050,34011818056,4171,2084,2087,99.8562529947293
SL050,34011818057,7378,3732,3646,102.358749314317
SL050,34011818059,5546,2741,2805,97.7183600713012
SL050,34011818061,1291,673,618,108.899676375405
SL050,34011818062,14851,7407,7444,99.5029554003224
SL050,34011818063,1583,805,778,103.470437017995
SL050,34011818064,420,213,207,102.898550724638
SL050,34011818065,723,367,356,103.089887640449
SL050,34011818066,2616,1311,1305,100.459770114943
SL050,34011818067,755,391,364,107.417582417582
SL050,34011818068,2032,1017,1015,100.197044334975
SL050,34011818069,621,337,284,118.661971830986
SL050,34011818070,320,170,150,113.333333333333
SL050,34011818071,6975,3467,3508,98.8312428734322
SL050,34011818072,789,404,385,104.935064935065
SL050,34011818074,300,155,145,106.896551724138
SL050,34011818076,993,517,476,108.613445378151
SL050,34011818078,900,460,440,104.545454545455
SL050,34011818079,4387,2197,2190,100.319634703196
SL050,34011818082,1090,549,541,101.478743068392
SL050,34011818083,233,110,123,89.4308943089431
SL050,34011818084,5703,2898,2805,103.31550802139
SL050,34011818085,736,377,359,105.013927576602
SL050,34011818086,379,196,183,107.103825136612
SL050,34011818087,232208,107414,124794,86.0730483837364
SL050,34011818088,1924,993,931,106.659505907626
SL050,34011818089,18718,9264,9454,97.9902686693463
SL050,34011818093,5210,2787,2423,115.022699133306
SL050,34011818094,2849,1517,1332,113.888888888889
SL050,34011818095,2541,1336,1205,110.871369294606
SL050,34011818096,388,203,185,109.72972972973
SL050,34011818097,1151,614,537,114.338919925512
SL050,34011818098,7367,3643,3724,97.8249194414608
SL050,34011818099,1882,970,912,106.359649122807
SL050,34011818100,10286,5182,5104,101.528213166144
SL050,34011818101,11966,6014,5952,101.041666666667
SL050,34011818102,10135,5063,5072,99.8225552050473
SL050,34011818103,1002,503,499,100.801603206413
SL050,34011818105,5085,2605,2480,105.040322580645
SL050,34011818106,599,326,273,119.413919413919
SL050,34011818107,1104,561,543,103.314917127072
SL050,34011818108,977,511,466,109.656652360515
SL050,34011818109,909,478,431,110.904872389791
SL050,34011818111,3785,1932,1853,104.263356718834
SL050,34011818112,142,68,74,91.8918918918919
SL050,34011818114,661,330,331,99.6978851963746
SL050,34011818115,3354,1721,1633,105.38885486834
SL050,34011818116,3485,1738,1747,99.4848311390956
SL050,34011818117,576,310,266,116.541353383459
SL050,34011818119,2103,1068,1035,103.188405797101
SL050,34011818120,328,172,156,110.25641025641
SL050,34011818121,148,78,70,111.428571428571
SL050,34011818122,20371,10143,10228,99.168947985921
SL050,34011818123,332,177,155,114.193548387097
SL050,34011818124,462,252,210,120
SL050,34011818126,1827,915,912,100.328947368421
SL050,34011818127,22047,10849,11198,96.8833720307198
SL050,34011818128,409,193,216,89.3518518518518
SL050,34011818132,3723,1857,1866,99.5176848874598
SL050,34011818133,2759,1411,1348,104.673590504451
SL050,34011818134,7826,4033,3793,106.327445293963
SL050,34011818135,5479,2763,2716,101.730486008837
SL050,34011818136,2163,1112,1051,105.803996194101
SL050,34011818137,1157,610,547,111.517367458867
SL050,34011818138,3159,1592,1567,101.595405232929
SL050,34011818140,60592,29831,30761,96.9766912649134
SL050,34011818141,464,259,205,126.341463414634
SL050,34011818143,1182,604,578,104.498269896194
SL050,34011818144,996,524,472,111.016949152542
SL050,34011818145,14025,6940,7085,97.9534227240649
SL050,34011818146,1198,609,589,103.39558573854
SL050,34011818147,5649,2837,2812,100.889046941679
SL050,34011818148,1029,523,506,103.359683794466
SL050,34011818149,6917,3478,3439,101.134050596104
SL050,34011818150,8396,4220,4176,101.053639846743
SL050,34011818151,321,160,161,99.3788819875776
SL050,34011818152,1134,556,578,96.1937716262976
SL050,34011818153,11286,5603,5683,98.592292803097
SL050,34011818154,1177,600,577,103.986135181976
SL050,34011818157,1449,762,687,110.917030567686
SL050,34011818158,10144,5101,5043,101.150109062066
SL050,34011818159,1120,608,512,118.75
SL050,34011818161,236,127,109,116.51376146789
SL050,34011818162,1703,929,774,120.025839793282
SL050,34011818163,389,199,190,104.736842105263
SL050,34011818164,2292,1176,1116,105.376344086022
SL050,34011818165,5348,2656,2692,98.6627043090639
SL050,34011818167,2312,1176,1136,103.521126760563
SL050,34011818168,916,468,448,104.464285714286
SL050,34011818170,382,212,170,124.705882352941
SL050,34011818171,2639,1330,1309,101.604278074866
SL050,34011818173,12396,6173,6223,99.1965290053029
SL050,34011818174,541,281,260,108.076923076923
SL050,34011818175,14986,7368,7618,96.7182987660803
SL050,34011818176,266,144,122,118.032786885246
SL050,34011818177,545,299,246,121.544715447154
SL050,34011818178,759,402,357,112.605042016807
SL050,34011818179,663,347,316,109.810126582278
SL050,34011818180,742,386,356,108.426966292135
SL050,34011818181,255,153,102,150
SL050,34011818182,2521,1240,1281,96.7993754879001
SL050,34011818183,672,344,328,104.878048780488
SL050,34011818184,2870,1425,1445,98.6159169550173
SL050,34011818185,610,332,278,119.424460431655
SL050,34011818187,585,310,275,112.727272727273
SL050,34011818188,2024,997,1027,97.078870496592
SL050,34011818189,980,509,471,108.067940552017
SL050,34011818192,2057,1097,960,114.270833333333
SL050,34011818193,18995,9374,9621,97.4326993036067
SL050,34011818194,2597,1338,1259,106.274821286736
SL050,34011818901,653,343,310,110.645161290323
SL050,34011818902,935,465,470,98.936170212766
SL050,34011818903,1079,556,523,106.309751434034
SL050,34011818904,978,550,428,128.504672897196
SL050,34011818905,20703,10547,10156,103.849940921623
SL050,34011818906,1028,538,490,109.795918367347
SL050,34011818907,2145,1094,1051,104.091341579448
SL050,34011818908,950,477,473,100.845665961945
SL050,34011818909,619,334,285,117.19298245614
SL050,34011818910,919,475,444,106.981981981982
SL050,34011818911,10981,5609,5372,104.411764705882
SL050,34011818912,1774,886,888,99.7747747747748
SL050,34011818913,855,432,423,102.127659574468
SL050,34011818914,2086,1020,1066,95.6848030018762
SL050,34011818915,890,465,425,109.411764705882
SL050,34081919001,53,29,24,120.833333333333
SL050,34081919002,60,34,26,130.769230769231
SL050,34081919003,31,17,14,121.428571428571
SL050,34081919004,62,27,35,77.1428571428571
SL050,34081919005,156,101,55,183.636363636364
SL050,34081919006,918,517,401,128.927680798005
SL050,34081919007,540,271,269,100.743494423792
SL050,34081919008,46,31,15,206.666666666667
SL050,34081919009,326,168,158,106.329113924051
SL050,34081919010,12,8,4,200
SL050,34081919011,321,174,147,118.367346938776
SL050,34081919013,125,79,46,171.739130434783
SL050,34081919015,84,49,35,140
SL050,34081919016,59,42,17,247.058823529412
SL050,34081919017,77,46,31,148.387096774194
SL050,34081919018,157,90,67,134.328358208955
SL050,34081919019,16,8,8,100
SL050,34081919020,58,38,20,190
SL050,34081919021,1306,686,620,110.645161290323
SL050,34081919022,720,352,368,95.6521739130435
SL050,34081919023,177,88,89,98.876404494382
SL050,34081919024,12570,6383,6187,103.167932762243
SL050,34081919027,157,89,68,130.882352941176
SL050,34081919031,10,8,2,400
SL050,34081919032,163,83,80,103.75
SL050,34081919033,51,29,22,131.818181818182
SL050,34081919034,23,17,6,283.333333333333
SL050,34081919036,390,205,185,110.810810810811
SL050,34081919037,158,93,65,143.076923076923
SL050,34081919038,26,19,7,271.428571428571
SL050,34081919039,65,44,21,209.52380952381
SL050,34081919040,51,32,19,168.421052631579
SL050,34081919041,226,124,102,121.56862745098
SL050,34081919042,22,12,10,120
SL050,34081919043,92,59,33,178.787878787879
SL050,34081919044,431,247,184,134.239130434783
SL050,34081919045,146,81,65,124.615384615385
SL050,34081919046,34685,17550,17135,102.421943390721
SL050,34081919047,55,29,26,111.538461538462
SL050,34081919048,17,12,5,240
SL050,34081919049,14,12,2,600
SL050,34081919050,16,11,5,220
SL050,34081919051,50,34,16,212.5
SL050,34081919052,26,16,10,160
SL050,34081919053,2399,1252,1147,109.154315605929
SL050,34081919054,208,122,86,141.860465116279
SL050,34081919055,43,21,22,95.4545454545455
SL050,34081919057,76,46,30,153.333333333333
SL050,34081919058,10123,5138,4985,103.069207622869
SL050,34081919059,79,45,34,132.352941176471
SL050,34081919060,147,94,53,177.358490566038
SL050,34081919061,52,38,14,271.428571428571
SL050,34081919064,63,40,23,173.913043478261
SL050,34081919065,144,88,56,157.142857142857
SL050,34081919066,58,33,25,132
SL050,34081919067,64,40,24,166.666666666667
SL050,34081919070,93,51,42,121.428571428571
SL050,34081919071,11812,6009,5803,103.549887988971
SL050,34081919073,18,15,3,500
SL050,34081919074,83,49,34,144.117647058824
SL050,34081919075,63,39,24,162.5
SL050,34081919076,26,14,12,116.666666666667
SL050,34081919078,56,36,20,180
SL050,34081919079,9,5,4,125
SL050,34081919080,71,39,32,121.875
SL050,34081919081,24,15,9,166.666666666667
SL050,34081919082,107,57,50,114
SL050,34081919086,1697,896,801,111.860174781523
SL050,34081919087,23,12,11,109.090909090909
SL050,34081919088,104,59,45,131.111111111111
SL050,34081919089,32,20,12,166.666666666667
SL050,34081919090,115,59,56,105.357142857143
SL050,34081919091,30,17,13,130.769230769231
SL050,34081919092,549,323,226,142.920353982301
SL050,34081919095,14,9,5,180
SL050,34081919096,105,60,45,133.333333333333
SL050,34081919097,16,12,4,300
SL050,34081919098,24,17,7,242.857142857143
SL050,34081919099,345,188,157,119.745222929936
SL050,34081919102,118,61,57,107.017543859649
SL050,34081919103,273,163,110,148.181818181818
SL050,34081919104,17,9,8,112.5
SL050,34081919105,3508,1819,1689,107.696862048549
SL050,34081919106,92,53,39,135.897435897436
SL050,34081919107,339,182,157,115.923566878981
SL050,34081919108,109,58,51,113.725490196078
SL050,34081919109,35,20,15,133.333333333333
SL050,34081919110,60,32,28,114.285714285714
SL050,34081919111,171,105,66,159.090909090909
SL050,34081919112,50,20,30,66.6666666666667
SL050,34081919113,665,343,322,106.521739130435
SL050,34081919114,38,26,12,216.666666666667
SL050,34081919115,30,17,13,130.769230769231
SL050,34081919116,13,8,5,160
SL050,34081919117,2364,1232,1132,108.833922261484
SL050,34081919118,8,5,3,166.666666666667
SL050,34081919119,88,56,32,175
SL050,34081919120,131,73,58,125.862068965517
SL050,34081919121,284,160,124,129.032258064516
SL050,34081919122,89,49,40,122.5
SL050,34081919123,43,24,19,126.315789473684
SL050,34081919124,526,290,236,122.881355932203
SL050,34081919125,49,33,16,206.25
SL050,34081919126,2416,1292,1124,114.946619217082
SL050,34081919127,107,58,49,118.367346938776
SL050,34081919129,29,17,12,141.666666666667
SL050,34081919130,84910,40835,44075,92.6488939307998
SL050,34081919132,100,52,48,108.333333333333
SL050,34081919133,272,165,107,154.205607476636
SL050,34081919134,19,12,7,171.428571428571
SL050,34081919135,118,67,51,131.372549019608
SL050,34081919136,19,10,9,111.111111111111
SL050,34081919138,307,169,138,122.463768115942
SL050,34081919139,29,18,11,163.636363636364
SL050,34081919142,299,178,121,147.107438016529
SL050,34081919143,2538,1288,1250,103.04
SL050,34081919145,43,26,17,152.941176470588
SL050,34081919146,44,28,16,175
SL050,34081919147,42,29,13,223.076923076923
SL050,34081919148,53,34,19,178.947368421053
SL050,34081919150,130,81,49,165.30612244898
SL050,34081919151,1487,731,756,96.6931216931217
SL050,34081919152,654,365,289,126.297577854671
SL050,34081919153,21,13,8,162.5
SL050,34081919154,63,42,21,200
SL050,34081919155,73,49,24,204.166666666667
SL050,34081919156,1434,752,682,110.263929618768
SL050,34081919157,55,39,16,243.75
SL050,34081919159,99,52,47,110.63829787234
SL050,34081919160,1199,658,541,121.626617375231
SL050,34081919161,250,130,120,108.333333333333
SL050,34081919162,72,41,31,132.258064516129
SL050,34081919163,67,34,33,103.030303030303
SL050,34081919165,55,31,24,129.166666666667
SL050,34081919166,183,101,82,123.170731707317
SL050,34081919167,156,87,69,126.086956521739
SL050,34081919168,297,149,148,100.675675675676
SL050,34081919169,37,22,15,146.666666666667
SL050,34081919170,222,120,102,117.647058823529
SL050,34081919171,7229,3626,3603,100.638356924785
SL050,34081919172,51,29,22,131.818181818182
SL050,34081919173,61,38,23,165.217391304348
SL050,34081919174,106,54,52,103.846153846154
SL050,34081919175,37,17,20,85
SL050,34081919176,257,136,121,112.396694214876
SL050,34081919177,72,37,35,105.714285714286
SL050,34081919178,30,19,11,172.727272727273
SL050,34081919179,88,51,37,137.837837837838
SL050,34081919181,60,37,23,160.869565217391
SL050,34081919182,40,26,14,185.714285714286
SL050,34081919183,77,47,30,156.666666666667
SL050,34081919184,102,63,39,161.538461538462
SL050,34081919185,28,19,9,211.111111111111
SL050,34081919186,83,49,34,144.117647058824
SL050,34081919187,55,32,23,139.130434782609
SL050,34081919188,48,27,21,128.571428571429
SL050,34081919189,172,91,81,112.345679012346
SL050,34081919190,3295,1654,1641,100.792199878123
SL050,34081919191,14,6,8,75
SL050,34081919192,2637,1356,1281,105.854800936768
SL050,34081919193,26,15,11,136.363636363636
SL050,34081919194,100,57,43,132.558139534884
SL050,34081919195,38,23,15,153.333333333333
SL050,34081919196,102,55,47,117.021276595745
SL050,34081919197,28,19,9,211.111111111111
SL050,34081919198,17,9,8,112.5
SL050,34081919199,18,13,5,260
SL050,34081919200,75,43,32,134.375
SL050,34081919201,64,35,29,120.689655172414
SL050,34081919202,9,5,4,125
SL050,34081919203,27,16,11,145.454545454545
SL050,34081919204,177,109,68,160.294117647059
SL050,34081919208,41,25,16,156.25
SL050,34081919209,44,25,19,131.578947368421
SL050,34081919210,19,10,9,111.111111111111
SL050,34081919211,389,228,161,141.614906832298
SL050,34081919212,873,439,434,101.152073732719
SL050,34081919213,77,47,30,156.666666666667
SL050,34081919214,76,44,32,137.5
SL050,34081919215,152,98,54,181.481481481482
SL050,34081919216,156,83,73,113.698630136986
SL050,34081919217,49,34,15,226.666666666667
SL050,34081919218,52,27,25,108
SL050,34081919219,11,9,2,450
SL050,34081919220,3770,1978,1792,110.379464285714
SL050,34081919221,56,36,20,180
SL050,34081919222,111,57,54,105.555555555556
SL050,34081919223,120,62,58,106.896551724138
SL050,34081919224,106,65,41,158.536585365854
SL050,34081919225,1269,676,593,113.996627318718
SL050,34081919226,42,29,13,223.076923076923
SL050,34081919227,61,40,21,190.47619047619
SL050,34081919228,36,21,15,140
SL050,34081919229,60,33,27,122.222222222222
SL050,34081919230,778,406,372,109.139784946237
SL050,34081919231,12,8,4,200
SL050,34081919232,60,38,22,172.727272727273
SL050,34081919233,92,54,38,142.105263157895
SL050,34081919234,42,28,14,200
SL050,34081919235,87,50,37,135.135135135135
SL050,34081919237,44,25,19,131.578947368421
SL050,34081919238,49,29,20,145
SL050,34081919239,106,53,53,100
SL050,34081919240,45,27,18,150
SL050,34081919241,42,25,17,147.058823529412
SL050,34081919242,100,53,47,112.765957446809
SL050,34081919243,40,30,10,300
SL050,34081919244,85,47,38,123.684210526316
SL050,34081919245,1519,792,727,108.940852819807
SL050,34081919246,44,23,21,109.52380952381
SL050,34081919247,155,87,68,127.941176470588
SL050,34081919248,72,46,26,176.923076923077
SL050,34081919249,35,19,16,118.75
SL050,34081919250,18,10,8,125
SL050,34081919251,53,31,22,140.909090909091
SL050,34081919252,81,47,34,138.235294117647
SL050,34081919254,47,22,25,88
SL050,34081919255,76,45,31,145.161290322581
SL050,34081919256,53,31,22,140.909090909091
SL050,34081919257,4356,2154,2202,97.8201634877384
SL050,34081919258,96,56,40,140
SL050,34081919259,35,16,19,84.2105263157895
SL050,34081919260,41,22,19,115.789473684211
SL050,34081919261,34,18,16,112.5
SL050,34081919262,123,67,56,119.642857142857
SL050,34081919263,44,22,22,100
SL050,34081919264,33,21,12,175
SL050,34081919265,149,88,61,144.262295081967
SL050,34081919266,304,166,138,120.289855072464
SL050,34081919267,22,12,10,120
SL050,34081919268,30,20,10,200
SL050,34081919269,96,55,41,134.146341463415
SL050,34081919270,13,10,3,333.333333333333
SL050,34081919271,50,28,22,127.272727272727
SL050,34081919272,96,54,42,128.571428571429
SL050,34081919274,1424,741,683,108.491947291362
SL050,34081919277,19,13,6,216.666666666667
SL050,34081919278,25,15,10,150
SL050,34081919279,502,268,234,114.529914529915
SL050,34081919280,5300,2754,2546,108.169677926159
SL050,34081919281,23,15,8,187.5
SL050,34081919282,175,102,73,139.72602739726
SL050,34081919283,40,19,21,90.4761904761905
SL050,34081919284,11,7,4,175
SL050,34081919285,22,12,10,120
SL050,34081919286,1012,561,451,124.390243902439
SL050,34081919287,206,115,91,126.373626373626
SL050,34081919288,18,12,6,200
SL050,34081919289,27,19,8,237.5
SL050,34081919290,1172,626,546,114.652014652015
SL050,34081919291,1319,693,626,110.702875399361
SL050,34081919293,2573,1334,1239,107.667473769169
SL050,34081919294,28,16,12,133.333333333333
SL050,34081919296,35,24,11,218.181818181818
SL050,34081919297,35,18,17,105.882352941176
SL050,34081919298,79,52,27,192.592592592593
SL050,34081919299,108,57,51,111.764705882353
SL050,34081919300,1062,556,506,109.881422924901
SL050,34081919301,40,24,16,150
SL050,34081919302,57,35,22,159.090909090909
SL050,34081919303,49,35,14,250
SL050,34081919304,253,140,113,123.893805309735
SL050,34081919305,168,99,69,143.478260869565
SL050,34081919306,22,12,10,120
SL050,34081919307,25,16,9,177.777777777778
SL050,34081919308,59,41,18,227.777777777778
SL050,34081919309,25,12,13,92.3076923076923
SL050,34081919310,8,5,3,166.666666666667
SL050,34081919311,82,44,38,115.789473684211
SL050,34081919314,48,32,16,200
SL050,34081919317,162,89,73,121.917808219178
SL050,34081919318,29,19,10,190
SL050,34081919319,6568,3298,3270,100.85626911315
SL050,34081919321,47,30,17,176.470588235294
SL050,34081919322,27,13,14,92.8571428571429
SL050,34081919323,36,21,15,140
SL050,34081919324,185,103,82,125.609756097561
SL050,34081919325,137,70,67,104.477611940299
SL050,34081919326,3518,1836,1682,109.155766944114
SL050,34081919327,444,236,208,113.461538461538
SL050,34081919329,63,33,30,110
SL050,34081919330,77,46,31,148.387096774194
SL050,34081919331,3937,1995,1942,102.729145211123
SL050,34081919332,86,50,36,138.888888888889
SL050,34081919333,125,82,43,190.697674418605
SL050,34081919334,37,21,16,131.25
SL050,34081919335,70,36,34,105.882352941176
SL050,34081919901,40,23,17,135.294117647059
SL050,34162020001,320,173,147,117.687074829932
SL050,34162020002,469,256,213,120.18779342723
SL050,34162020003,777,394,383,102.872062663185
SL050,34162020004,309,160,149,107.38255033557
SL050,34162020005,1726,884,842,104.988123515439
SL050,34162020006,374,183,191,95.8115183246073
SL050,34162020007,427,223,204,109.313725490196
SL050,34162020008,939,508,431,117.865429234339
SL050,34162020009,14618,7209,7409,97.3005803752193
SL050,34162020010,2034,1052,982,107.128309572301
SL050,34162020011,2136,1070,1066,100.375234521576
SL050,34162020012,205,100,105,95.2380952380952
SL050,34162020013,6987,3514,3473,101.180535560035
SL050,34162020014,1533,802,731,109.712722298222
SL050,34162020015,1669,863,806,107.071960297767
SL050,34162020016,2081,1098,983,111.698880976602
SL050,34162020017,11609,5768,5841,98.7502140044513
SL050,34162020018,14786,7387,7399,99.8378159210704
SL050,34162020019,13881,6938,6943,99.9279850208844
SL050,34162020020,151,90,61,147.540983606557
SL050,34162020021,239,129,110,117.272727272727
SL050,34162020022,1081,559,522,107.088122605364
SL050,34162020023,602,315,287,109.756097560976
SL050,34162020024,508,279,229,121.834061135371
SL050,34162020025,1519,773,746,103.619302949062
SL050,34162020026,252,120,132,90.9090909090909
SL050,34162020027,3725,1955,1770,110.45197740113
SL050,34162020028,2976,1489,1487,100.134498991258
SL050,34162020029,5457,2717,2740,99.1605839416058
SL050,34162020030,27406,13294,14112,94.203514739229
SL050,34162020031,239,123,116,106.034482758621
SL050,34162020032,11582,5730,5852,97.9152426520848
SL050,34162020033,1135,572,563,101.598579040853
SL050,34162020034,4087,2052,2035,100.835380835381
SL050,34162020035,575,296,279,106.093189964158
SL050,34162020036,17018,8462,8556,98.901355773726
SL050,34162020037,129,74,55,134.545454545455
SL050,34162020038,488,256,232,110.344827586207
SL050,34162020039,2818,1428,1390,102.73381294964
SL050,34162020040,20222,9890,10332,95.7220286488579
SL050,34162020041,313,165,148,111.486486486486
SL050,34162020042,4172,2082,2090,99.6172248803828
SL050,34162020043,2305,1170,1135,103.083700440529
SL050,34162020044,488,248,240,103.333333333333
SL050,34162020045,61983,30306,31677,95.6719386305521
SL050,34162020046,1862,961,901,106.659267480577
SL050,34162020047,641,327,314,104.140127388535
SL050,34162020048,253,139,114,121.929824561404
SL050,34162020049,5646,2838,2808,101.068376068376
SL050,34162020050,377,195,182,107.142857142857
SL050,34162020051,8384,4251,4133,102.855068957174
SL050,34162020052,1430,728,702,103.703703703704
SL050,34162020053,6045,3006,3039,98.9141164856861
SL050,34162020054,602,312,290,107.586206896552
SL050,34162020055,22019,10822,11197,96.6508886308833
SL050,34162020056,5354,2712,2642,102.649507948524
SL050,34162020057,252,139,113,123.008849557522
SL050,34162020058,945,478,467,102.355460385439
SL050,34162020059,11335,5601,5734,97.6805022671782
SL050,34162020060,123,67,56,119.642857142857
SL050,34162020061,5948,2998,2950,101.627118644068
SL050,34162020062,1302,661,641,103.120124804992
SL050,34162020063,10276,5103,5173,98.6468200270636
SL050,34162020064,16128,7739,8389,92.2517582548575
SL050,34162020065,3894,1945,1949,99.7947665469472
SL050,34162020066,589,311,278,111.870503597122
SL050,34162020067,39355,19037,20318,93.6952455950389
SL050,34162020068,232,129,103,125.242718446602
SL050,34162020069,186665,87764,98901,88.7392442947998
SL050,34162020070,1432,720,712,101.123595505618
SL050,34162020071,19525,9431,10094,93.4317416286903
SL050,34162020072,6170,3080,3090,99.6763754045307
SL050,34162020073,6165,3092,3073,100.618288317605
SL050,34162020074,14596,7257,7339,98.8826815642458
SL050,34162020075,5881,2938,2943,99.8301053346925
SL050,34162020076,10150,4996,5154,96.9344198680636
SL050,34162020077,6730,3319,3411,97.3028437408385
SL050,34162020078,1613,827,786,105.216284987277
SL050,34162020079,23223,11308,11915,94.9055812001679
SL050,34162020080,9834,4857,4977,97.588908981314
SL050,34162020081,10044,5004,5040,99.2857142857143
SL050,34162020901,2010,1014,996,101.807228915663
SL050,34162020902,18253,8873,9380,94.5948827292111
SL050,34162020903,6272,3204,3068,104.432855280313
SL050,34162020904,137,75,62,120.967741935484
SL050,34162020905,218,112,106,105.660377358491
SL050,34162020906,179,87,92,94.5652173913043
SL050,34162020907,153,83,70,118.571428571429
SL050,34012121001,763,385,378,101.851851851852
SL050,34012121002,21054,10466,10588,98.8477521722705
SL050,34012121003,837,439,398,110.301507537688
SL050,34012121004,1837,984,853,115.357561547479
SL050,34012121005,24013,11642,12371,94.1071861611834
SL050,34012121006,3942,1926,2016,95.5357142857143
SL050,34012121007,8040,3959,4081,97.0105366331781
SL050,34012121008,3109,1553,1556,99.8071979434447
SL050,34012121009,965,502,463,108.423326133909
SL050,34012121010,20883,10483,10400,100.798076923077
SL050,34012121011,4236,2135,2101,101.618277010947
SL050,34012121012,319,160,159,100.62893081761
SL050,34012121013,14114,7016,7098,98.8447449985912
SL050,34012121014,6060,3017,3043,99.1455800197174
SL050,34012121015,741,387,354,109.322033898305
SL050,34012121016,1184,600,584,102.739726027397
SL050,34012121017,4077,2068,2009,102.936784469886
SL050,34012121018,2036,986,1050,93.9047619047619
SL050,34012121019,702,356,346,102.890173410405
SL050,34012121020,411,209,202,103.465346534653
SL050,34012121021,19433,9974,9459,105.444550163865
SL050,34012121022,209,118,91,129.67032967033
SL050,34012121023,2389,1187,1202,98.7520798668885
SL050,34012121024,543,274,269,101.85873605948
SL050,34012121025,4735,2406,2329,103.306139974238
SL050,34012121026,305,147,158,93.0379746835443
SL050,34012121027,57,34,23,147.826086956522
SL050,34012121028,373,186,187,99.4652406417112
SL050,34012121029,1785,882,903,97.6744186046512
SL050,34012121030,2232,1136,1096,103.649635036496
SL050,34012121031,1332,669,663,100.904977375566
SL050,34012121032,2278,1109,1169,94.8674080410607
SL050,34012121033,623,314,309,101.618122977346
SL050,34012121034,1401,685,716,95.6703910614525
SL050,34012121035,12548,6259,6289,99.5229766258547
SL050,34012121036,235,123,112,109.821428571429
SL050,34012121037,519,277,242,114.462809917355
SL050,34012121038,1293,666,627,106.22009569378
SL050,34012121039,307,151,156,96.7948717948718
SL050,34012121040,3909,1962,1947,100.770416024653
SL050,34012121041,144258,69336,74922,92.5442460158565
SL050,34012121042,21077,10540,10537,100.028471101832
SL050,34012121043,2258,1136,1122,101.247771836007
SL050,34012121044,27047,13951,13096,106.528711056811
SL050,34012121045,262,129,133,96.9924812030075
SL050,34012121046,3395,1778,1617,109.95670995671
SL050,34012121047,2079,1056,1023,103.225806451613
SL050,34012121048,402,215,187,114.973262032086
SL050,34012121049,3866,1870,1996,93.687374749499
SL050,34012121050,21699,10862,10837,100.230691150687
SL050,34012121051,253,132,121,109.090909090909
SL050,34012121052,5303,2555,2748,92.9767103347889
SL050,34012121053,4103,2071,2032,101.919291338583
SL050,34012121054,10762,5357,5405,99.1119333950046
SL050,34012121055,11112,5613,5499,102.073104200764
SL050,34012121056,3484,1760,1724,102.088167053364
SL050,34012121057,1167,590,577,102.253032928943
SL050,34012121058,3142,1612,1530,105.359477124183
SL050,34012121059,281,138,143,96.5034965034965
SL050,34012121060,15134,7715,7419,103.98975603181
SL050,34012121061,7751,3927,3824,102.693514644351
SL050,34012121062,1707,849,858,98.9510489510489
SL050,34012121063,3679,1828,1851,98.7574284170719
SL050,34012121064,9198,4635,4563,101.577909270217
SL050,34012121065,396,196,200,98
SL050,34012121066,607,316,291,108.591065292096
SL050,34012121067,480,229,251,91.2350597609562
SL050,34012121068,1054,519,535,97.0093457943925
SL050,34012121069,2004,1039,965,107.668393782383
SL050,34012121070,7782,3868,3914,98.8247317322432
SL050,34012121071,243,112,131,85.4961832061069
SL050,34012121072,12780,6285,6495,96.7667436489607
SL050,34012121073,2839,1398,1441,97.0159611380985
SL050,34012121074,3283,1623,1660,97.7710843373494
SL050,34012121075,382,180,202,89.1089108910891
SL050,34012121076,2761,1383,1378,100.362844702467
SL050,34012121077,2152,1083,1069,101.309635173059
SL050,34012121078,3090,1563,1527,102.357563850688
SL050,34012121079,831,432,399,108.270676691729
SL050,34022222001,237,124,113,109.734513274336
SL050,34022222002,151,76,75,101.333333333333
SL050,34022222003,172,91,81,112.345679012346
SL050,34022222004,130,78,52,150
SL050,34022222006,321,174,147,118.367346938776
SL050,34022222007,1102,586,516,113.565891472868
SL050,34022222008,181,102,79,129.113924050633
SL050,34022222009,721,376,345,108.985507246377
SL050,34022222011,105,63,42,150
SL050,34022222012,141,76,65,116.923076923077
SL050,34022222013,309,158,151,104.635761589404
SL050,34022222014,246,130,116,112.068965517241
SL050,34022222015,325,179,146,122.602739726027
SL050,34022222016,652,320,332,96.3855421686747
SL050,34022222017,1160,614,546,112.454212454212
SL050,34022222018,363,194,169,114.792899408284
SL050,34022222019,201,101,100,101
SL050,34022222020,127,66,61,108.196721311475
SL050,34022222021,2394,1228,1166,105.317324185249
SL050,34022222022,654,338,316,106.962025316456
SL050,34022222023,471,236,235,100.425531914894
SL050,34022222024,296,158,138,114.492753623188
SL050,34022222025,1409,743,666,111.561561561562
SL050,34022222027,367,196,171,114.619883040936
SL050,34022222028,431,217,214,101.401869158879
SL050,34022222029,149,75,74,101.351351351351
SL050,34022222032,116,64,52,123.076923076923
SL050,34022222035,318,173,145,119.310344827586
SL050,34022222036,96,56,40,140
SL050,34022222037,129,70,59,118.64406779661
SL050,34022222039,1041,516,525,98.2857142857143
SL050,34022222040,176,83,93,89.247311827957
SL050,34022222041,174,85,89,95.5056179775281
SL050,34022222042,153,70,83,84.3373493975904
SL050,34022222043,104,59,45,131.111111111111
SL050,34022222044,279,166,113,146.902654867257
SL050,34022222045,77,44,33,133.333333333333
SL050,34022222046,823,424,399,106.265664160401
SL050,34022222047,292,153,139,110.071942446043
SL050,34022222048,16944,8236,8708,94.5796968305007
SL050,34022222049,77,44,33,133.333333333333
SL050,34022222050,95,49,46,106.521739130435
SL050,34022222051,105,59,46,128.260869565217
SL050,34022222052,1292,733,559,131.127012522361
SL050,34022222053,1107,569,538,105.762081784387
SL050,34022222054,2157,1150,1007,114.200595829196
SL050,34022222055,345,177,168,105.357142857143
SL050,34022222057,476,254,222,114.414414414414
SL050,34022222058,231,130,101,128.712871287129
SL050,34022222059,1479,776,703,110.384068278805
SL050,34022222060,1555,828,727,113.892709766162
SL050,34022222061,9435,4935,4500,109.666666666667
SL050,34022222062,181,98,83,118.072289156627
SL050,34022222063,189,102,87,117.241379310345
SL050,34022222064,183,104,79,131.645569620253
SL050,34022222066,986,534,452,118.141592920354
SL050,34022222067,86,50,36,138.888888888889
SL050,34022222068,80,48,32,150
SL050,34022222069,531,301,230,130.869565217391
SL050,34022222072,218,129,89,144.943820224719
SL050,34022222074,323,171,152,112.5
SL050,34022222075,137,72,65,110.769230769231
SL050,34022222076,321,178,143,124.475524475524
SL050,34022222077,317,168,149,112.751677852349
SL050,34022222078,532,294,238,123.529411764706
SL050,34022222079,174,77,97,79.3814432989691
SL050,34022222080,354,186,168,110.714285714286
SL050,34022222081,269,145,124,116.935483870968
SL050,34022222082,315,164,151,108.609271523179
SL050,34022222083,531,284,247,114.97975708502
SL050,34022222084,753,387,366,105.737704918033
SL050,34022222085,108,58,50,116
SL050,34022222086,267,140,127,110.236220472441
SL050,34022222087,86,51,35,145.714285714286
SL050,34022222088,169,85,84,101.190476190476
SL050,34022222089,312,167,145,115.172413793103
SL050,34022222090,114,64,50,128
SL050,34022222094,108,55,53,103.77358490566
SL050,34022222095,86,54,32,168.75
SL050,34022222096,391,200,191,104.712041884817
SL050,34022222099,541,266,275,96.7272727272727
SL050,34022222102,204,117,87,134.48275862069
SL050,34022222103,794,383,411,93.1873479318735
SL050,34022222105,126,69,57,121.052631578947
SL050,34022222106,23,12,11,109.090909090909
SL050,34022222107,97,61,36,169.444444444444
SL050,34022222109,327,182,145,125.51724137931
SL050,34022222110,870,432,438,98.6301369863014
SL050,34022222111,173,92,81,113.58024691358
SL050,34022222112,14979,7594,7385,102.830060934326
SL050,34022222113,597,314,283,110.95406360424
SL050,34022222114,149,81,68,119.117647058824
SL050,34022222115,426,228,198,115.151515151515
SL050,34022222116,1753,907,846,107.210401891253
SL050,34022222117,3305,1617,1688,95.7938388625592
SL050,34022222119,1476,755,721,104.715672676838
SL050,34022222122,76,37,39,94.8717948717949
SL050,34022222124,218,118,100,118
SL050,34022222125,52463,25023,27440,91.1916909620991
SL050,34022222126,97,55,42,130.952380952381
SL050,34022222127,705,366,339,107.964601769912
SL050,34022222128,212,110,102,107.843137254902
SL050,34022222129,238,126,112,112.5
SL050,34022222130,12813,6302,6511,96.790047611734
SL050,34022222131,92,53,39,135.897435897436
SL050,34022222133,162,91,71,128.169014084507
SL050,34022222135,194,103,91,113.186813186813
SL050,34022222136,913,475,438,108.447488584475
SL050,34022222137,1202,637,565,112.743362831858
SL050,34022222139,91,48,43,111.627906976744
SL050,34022222141,126,80,46,173.913043478261
SL050,34022222142,136,70,66,106.060606060606
SL050,34022222143,230,134,96,139.583333333333
SL050,34022222144,291,160,131,122.137404580153
SL050,34022222149,331,184,147,125.170068027211
SL050,34022222150,522,296,226,130.973451327434
SL050,34022222151,106,52,54,96.2962962962963
SL050,34022222155,73,39,34,114.705882352941
SL050,34022222156,403,220,183,120.218579234973
SL050,34022222157,215,121,94,128.723404255319
SL050,34022222158,17061,8614,8447,101.977033266248
SL050,34022222160,269,141,128,110.15625
SL050,34022222162,155,75,80,93.75
SL050,34022222163,532,292,240,121.666666666667
SL050,34022222164,50,24,26,92.3076923076923
SL050,34022222165,533,269,264,101.893939393939
SL050,34022222167,687,377,310,121.612903225806
SL050,34022222168,27,14,13,107.692307692308
SL050,34022222170,786,404,382,105.759162303665
SL050,34022222172,622,315,307,102.605863192182
SL050,34022222173,251,158,93,169.89247311828
SL050,34022222174,562,295,267,110.486891385768
SL050,34022222175,219,125,94,132.978723404255
SL050,34022222176,199,99,100,99
SL050,34022222177,109,58,51,113.725490196078
SL050,34022222178,110,63,47,134.042553191489
SL050,34022222181,98,54,44,122.727272727273
SL050,34022222182,287,145,142,102.112676056338
SL050,34022222184,200,108,92,117.391304347826
SL050,34022222186,218,104,114,91.2280701754386
SL050,34022222187,372,185,187,98.9304812834225
SL050,34022222188,93,40,53,75.4716981132076
SL050,34022222189,215,121,94,128.723404255319
SL050,34022222190,154,89,65,136.923076923077
SL050,34022222193,314,158,156,101.282051282051
SL050,34022222195,283,138,145,95.1724137931034
SL050,34022222197,541,274,267,102.621722846442
SL050,34022222199,9245,4621,4624,99.9351211072664
SL050,34022222200,294,153,141,108.510638297872
SL050,34022222201,308,159,149,106.711409395973
SL050,34022222202,167,81,86,94.1860465116279
SL050,34022222203,96,54,42,128.571428571429
SL050,34022222204,1463,728,735,99.0476190476191
SL050,34022222205,506,257,249,103.212851405622
SL050,34022222206,219,118,101,116.831683168317
SL050,34022222207,152,86,66,130.30303030303
SL050,34022222208,231,124,107,115.88785046729
SL050,34022222209,180,109,71,153.521126760563
SL050,34022222212,81,43,38,113.157894736842
SL050,34022222213,4168,2167,2001,108.295852073963
SL050,34022222214,146,67,79,84.8101265822785
SL050,34022222215,150,83,67,123.880597014925
SL050,34022222217,489,261,228,114.473684210526
SL050,34022222218,41,20,21,95.2380952380952
SL050,34022222220,167,94,73,128.767123287671
SL050,34022222221,127,68,59,115.254237288136
SL050,34022222222,664,366,298,122.818791946309
SL050,34022222223,94,50,44,113.636363636364
SL050,34022222225,3528,1819,1709,106.436512580456
SL050,34022222226,952,474,478,99.163179916318
SL050,34022222227,226,126,100,126
SL050,34022222228,758,378,380,99.4736842105263
SL050,34022222229,123,67,56,119.642857142857
SL050,34022222230,298,155,143,108.391608391608
SL050,34022222232,103,57,46,123.913043478261
SL050,34022222233,102,54,48,112.5
SL050,34022222234,1148,577,571,101.050788091068
SL050,34022222235,92,56,36,155.555555555556
SL050,34022222236,266,134,132,101.515151515152
SL050,34022222239,99,62,37,167.567567567568
SL050,34022222242,69,43,26,165.384615384615
SL050,34022222243,34,20,14,142.857142857143
SL050,34022222244,46,23,23,100
SL050,34022222245,463,244,219,111.415525114155
SL050,34022222246,78,46,32,143.75
SL050,34022222247,36,24,12,200
SL050,34022222248,116,68,48,141.666666666667
SL050,34022222249,159,79,80,98.75
SL050,34022222250,447,237,210,112.857142857143
SL050,34022222251,394,199,195,102.051282051282
SL050,34022222252,147,85,62,137.096774193548
SL050,34022222253,60,36,24,150
SL050,34022222254,1774,939,835,112.455089820359
SL050,34022222901,839,442,397,111.335012594458
SL050,34022222902,260,130,130,100
SL050,34022222903,813,419,394,106.345177664975
SL050,34022222904,894,472,422,111.848341232227
SL050,34022222905,341,171,170,100.588235294118
SL050,34022222906,208,112,96,116.666666666667
SL050,34022222907,2151,1084,1067,101.593252108716
SL050,34022222908,226,131,95,137.894736842105
SL050,34022222909,399,210,189,111.111111111111
SL050,34012323001,1027,536,491,109.164969450102
SL050,34012323002,21708,10678,11030,96.8087035358114
SL050,34012323003,10558,5193,5365,96.7940354147251
SL050,34012323004,501,270,231,116.883116883117
SL050,34012323005,37113,18179,18934,96.0124643498468
SL050,34012323006,5595,2756,2839,97.076435364565
SL050,34012323007,3610,1820,1790,101.675977653631
SL050,34012323008,1767,884,883,100.113250283126
SL050,34012323009,15902,7898,8004,98.6756621689155
SL050,34012323010,17820,8842,8978,98.4851860102473
SL050,34012323011,2611,1343,1268,105.914826498423
SL050,34012323012,5191,2700,2491,108.390204737053
SL050,34012323014,3075,1550,1525,101.639344262295
SL050,34012323015,1567,789,778,101.413881748072
SL050,34012323016,457,238,219,108.675799086758
SL050,34012323017,1840,965,875,110.285714285714
SL050,34012323018,2739,1427,1312,108.765243902439
SL050,34012323019,1784,919,865,106.242774566474
SL050,34012323020,1882,963,919,104.787812840044
SL050,34012323021,606,313,293,106.825938566553
SL050,34012323024,15306,7569,7737,97.8286157425359
SL050,34012323025,3364,1697,1667,101.799640071986
SL050,34012323026,4120,2038,2082,97.8866474543708
SL050,34012323027,829,410,419,97.8520286396181
SL050,34012323028,7574,3690,3884,95.005149330587
SL050,34012323029,962,491,471,104.246284501062
SL050,34012323030,1459,704,755,93.2450331125828
SL050,34012323031,949,472,477,98.9517819706499
SL050,34012323032,643,317,326,97.239263803681
SL050,34012323033,1592,799,793,100.756620428752
SL050,34012323034,3086,1531,1555,98.4565916398714
SL050,34012323035,1387,715,672,106.39880952381
SL050,34012323037,614,332,282,117.730496453901
SL050,34012323038,4965,2527,2438,103.650533223954
SL050,34012323039,2779,1395,1384,100.794797687861
SL050,34012323040,1742,852,890,95.7303370786517
SL050,34012323041,616,329,287,114.634146341463
SL050,34012323042,335,175,160,109.375
SL050,34012323043,620,312,308,101.298701298701
SL050,34012323044,5845,2905,2940,98.8095238095238
SL050,34012323045,2527,1270,1257,101.034208432776
SL050,34012323046,2884,1448,1436,100.8356545961
SL050,34012323047,1935,964,971,99.2790937178167
SL050,34012323048,995,514,481,106.860706860707
SL050,34012323049,2070,1042,1028,101.36186770428
SL050,34012323050,113457,54533,58924,92.5480279682303
SL050,34012323051,3327,1684,1643,102.49543517955
SL050,34012323052,1286,622,664,93.6746987951807
SL050,34012323053,11805,5877,5928,99.1396761133603
SL050,34012323054,482,244,238,102.521008403361
SL050,34012323055,57811,28279,29532,95.7571447920899
SL050,34012323056,3673,1849,1824,101.370614035088
SL050,34012323057,852,415,437,94.9656750572082
SL050,34012323058,11322,5627,5695,98.8059701492537
SL050,34012323059,6877,3429,3448,99.4489559164733
SL050,34012323060,24207,12006,12201,98.4017703466929
SL050,34012323061,9927,4941,4986,99.0974729241877
SL050,34012323062,1716,882,834,105.755395683453
SL050,34012323063,4555,2280,2275,100.21978021978
SL050,34012323064,1948,983,965,101.865284974093
SL050,34012323065,1835,928,907,102.315325248071
SL050,34012323066,5277,2607,2670,97.6404494382023
SL050,34012323067,2916,1464,1452,100.826446280992
SL050,34012323069,6283,3171,3112,101.89588688946
SL050,34012323070,4708,2391,2317,103.193785066897
SL050,34012323071,2179,1091,1088,100.275735294118
SL050,34012323072,2339,1163,1176,98.8945578231292
SL050,34012323073,5303,2689,2614,102.869166029074
SL050,34012323074,3580,1828,1752,104.337899543379
SL050,34012323075,3958,1953,2005,97.4064837905237
SL050,34012323076,913,483,430,112.325581395349
SL050,34012323077,697,367,330,111.212121212121
SL050,34012323079,4520,2324,2196,105.828779599271
SL050,34012323080,2154,1079,1075,100.372093023256
SL050,34012323081,1782,876,906,96.6887417218543
SL050,34012323082,2262,1134,1128,100.531914893617
SL050,34012323084,1124,583,541,107.763401109057
SL050,34012323085,2564,1297,1267,102.367797947908
SL050,34012323086,14335,7168,7167,100.013952839403
SL050,34012323087,13731,6747,6984,96.606529209622
SL050,34012323088,7286,3554,3732,95.2304394426581
SL050,34012323090,1434,720,714,100.840336134454
SL050,34012323091,804,417,387,107.751937984496
SL050,34012323092,34602,16960,17642,96.1342251445414
SL050,34012323093,3799,1875,1924,97.4532224532225
SL050,34012323094,4519,2274,2245,101.291759465479
SL050,34012323095,10795,5417,5378,100.725176645593
SL050,34012323096,3146,1582,1564,101.150895140665
SL050,34012323097,8301,4264,4037,105.622987366857
SL050,34012323098,966,490,476,102.941176470588
SL050,34012323099,5980,2991,2989,100.066912010706
SL050,34012323101,416,221,195,113.333333333333
SL050,34012323901,1373,717,656,109.298780487805
SL050,34012323902,2682,1342,1340,100.149253731343
SL050,34012323903,4357,2215,2142,103.408029878618
SL050,34012323904,3060,1573,1487,105.783456624075
SL050,34012323905,2323,1182,1141,103.593339176161
SL050,34072424001,202,117,85,137.647058823529
SL050,34072424002,286,145,141,102.836879432624
SL050,34072424003,671,338,333,101.501501501502
SL050,34072424004,558,321,237,135.443037974684
SL050,34072424005,377,220,157,140.127388535032
SL050,34072424006,533,292,241,121.161825726141
SL050,34072424007,802,403,399,101.002506265664
SL050,34072424008,11029,5204,5825,89.3390557939914
SL050,34072424009,308,166,142,116.901408450704
SL050,34072424010,10307,4976,5331,93.3408366160195
SL050,34072424011,194,108,86,125.581395348837
SL050,34072424012,313,178,135,131.851851851852
SL050,34072424014,8979,4372,4607,94.8990666377252
SL050,34072424015,2497,1228,1269,96.769109535067
SL050,34072424016,489,279,210,132.857142857143
SL050,34072424017,580,297,283,104.946996466431
SL050,34072424018,193,97,96,101.041666666667
SL050,34072424019,360,169,191,88.4816753926702
SL050,34072424020,475,281,194,144.845360824742
SL050,34072424021,1850,942,908,103.74449339207
SL050,34072424022,319,169,150,112.666666666667
SL050,34072424023,287,154,133,115.789473684211
SL050,34072424024,733,388,345,112.463768115942
SL050,34072424025,304,177,127,139.370078740157
SL050,34072424026,1184,610,574,106.271777003484
SL050,34072424027,1330,688,642,107.165109034268
SL050,34072424028,412,226,186,121.505376344086
SL050,34072424029,775,404,371,108.894878706199
SL050,34072424030,5132,2551,2581,98.8376598217745
SL050,34072424031,231,134,97,138.144329896907
SL050,34072424032,123,55,68,80.8823529411765
SL050,34072424033,203,112,91,123.076923076923
SL050,34072424034,4062,2018,2044,98.7279843444227
SL050,34072424036,273,149,124,120.161290322581
SL050,34072424037,357,197,160,123.125
SL050,34072424038,3472,1728,1744,99.0825688073395
SL050,34072424039,2269,1146,1123,102.048085485307
SL050,34072424040,465,250,215,116.279069767442
SL050,34072424041,557,283,274,103.284671532847
SL050,34072424042,65,38,27,140.740740740741
SL050,34072424043,122,71,51,139.21568627451
SL050,34072424044,164,72,92,78.2608695652174
SL050,34072424046,979,504,475,106.105263157895
SL050,34072424047,794,423,371,114.016172506739
SL050,34072424049,1658,851,807,105.45229244114
SL050,34072424050,113,59,54,109.259259259259
SL050,34072424051,426,221,205,107.80487804878
SL050,34072424052,153,94,59,159.322033898305
SL050,34072424053,461,251,210,119.52380952381
SL050,34072424054,472,244,228,107.017543859649
SL050,34072424055,740,396,344,115.116279069767
SL050,34072424056,3150,1555,1595,97.4921630094044
SL050,34072424057,1533,767,766,100.130548302872
SL050,34072424058,209,119,90,132.222222222222
SL050,34072424059,914,468,446,104.932735426009
SL050,34072424060,544,290,254,114.173228346457
SL050,34072424061,2018,1027,991,103.632694248234
SL050,34072424062,147,84,63,133.333333333333
SL050,34072424063,404,214,190,112.631578947368
SL050,34072424064,1839,973,866,112.355658198614
SL050,34072424065,2564,1344,1220,110.16393442623
SL050,34072424066,495,235,260,90.3846153846154
SL050,34072424067,686,358,328,109.146341463415
SL050,34072424068,462,241,221,109.049773755656
SL050,34072424069,42,24,18,133.333333333333
SL050,34072424070,4551,2230,2321,96.0792761740629
SL050,34072424071,1108,539,569,94.7275922671353
SL050,34072424073,500,258,242,106.611570247934
SL050,34072424074,95,49,46,106.521739130435
SL050,34072424076,1475,807,668,120.808383233533
SL050,34072424077,244,119,125,95.2
SL050,34072424078,406,206,200,103
SL050,34072424079,944,514,430,119.53488372093
SL050,34072424080,223,108,115,93.9130434782609
SL050,34072424081,128,66,62,106.451612903226
SL050,34072424082,987,497,490,101.428571428571
SL050,34072424083,1142,593,549,108.014571948998
SL050,34072424084,174,86,88,97.7272727272727
SL050,34072424086,298,159,139,114.388489208633
SL050,34072424087,666,356,310,114.838709677419
SL050,34072424088,1066,549,517,106.189555125725
SL050,34072424089,124772,56536,68236,82.8536256521484
SL050,34072424090,383,201,182,110.43956043956
SL050,34072424091,645,341,304,112.171052631579
SL050,34072424092,831,432,399,108.270676691729
SL050,34072424093,362,187,175,106.857142857143
SL050,34072424094,1743,875,868,100.806451612903
SL050,34072424095,333,179,154,116.233766233766
SL050,34072424096,118,70,48,145.833333333333
SL050,34072424097,232,123,109,112.844036697248
SL050,34072424098,1306,687,619,110.985460420032
SL050,34072424099,175,92,83,110.843373493976
SL050,34072424100,872,480,392,122.448979591837
SL050,34072424101,395,196,199,98.4924623115578
SL050,34072424102,680,344,336,102.380952380952
SL050,34072424103,278,164,114,143.859649122807
SL050,34072424104,271,147,124,118.548387096774
SL050,34072424105,1835,945,890,106.179775280899
SL050,34072424106,240,138,102,135.294117647059
SL050,34072424107,279,169,110,153.636363636364
SL050,34072424108,382,185,197,93.9086294416244
SL050,34072424109,989,526,463,113.606911447084
SL050,34072424110,1293,662,631,104.912836767036
SL050,34072424112,317,185,132,140.151515151515
SL050,34072424113,382,197,185,106.486486486486
SL050,34072424114,3325,1689,1636,103.239608801956
SL050,34072424115,65239,31021,34218,90.6569641709042
SL050,34072424116,433,253,180,140.555555555556
SL050,34072424117,439,221,218,101.376146788991
SL050,34072424118,122,68,54,125.925925925926
SL050,34072424119,793,404,389,103.856041131105
SL050,34072424120,355,205,150,136.666666666667
SL050,34072424121,671,379,292,129.794520547945
SL050,34072424122,1511,789,722,109.279778393352
SL050,34072424123,748,415,333,124.624624624625
SL050,34072424124,381,208,173,120.231213872832
SL050,34072424125,354,178,176,101.136363636364
SL050,34072424127,293,159,134,118.65671641791
SL050,34072424129,123,67,56,119.642857142857
SL050,34072424130,474,277,197,140.609137055838
SL050,34072424131,772,410,362,113.259668508287
SL050,34072424132,622,352,270,130.37037037037
SL050,34072424133,379,209,170,122.941176470588
SL050,34072424134,3884,1935,1949,99.281682914315
SL050,34072424136,550,278,272,102.205882352941
SL050,34072424137,1161,589,572,102.972027972028
SL050,34072424139,2517,1237,1280,96.640625
SL050,34072424141,106,59,47,125.531914893617
SL050,34072424142,30820,14748,16072,91.7620706819313
SL050,34072424143,561,278,283,98.2332155477032
SL050,34072424144,716,365,351,103.988603988604
SL050,34072424145,665,362,303,119.471947194719
SL050,34072424146,261,134,127,105.511811023622
SL050,34072424148,1875,964,911,105.817782656422
SL050,34072424149,168,88,80,110
SL050,34072424150,237,128,109,117.43119266055
SL050,34072424151,490,261,229,113.973799126638
SL050,34072424152,504,273,231,118.181818181818
SL050,34072424153,273,142,131,108.396946564886
SL050,34072424154,1092,568,524,108.396946564886
SL050,34072424155,492,257,235,109.36170212766
SL050,34072424156,233,129,104,124.038461538462
SL050,34072424157,3096,1521,1575,96.5714285714286
SL050,34072424158,326,170,156,108.974358974359
SL050,34072424159,1939,967,972,99.4855967078189
SL050,34072424160,757,401,356,112.640449438202
SL050,34072424161,334,186,148,125.675675675676
SL050,34072424162,2108,1068,1040,102.692307692308
SL050,34072424163,5040,2511,2529,99.288256227758
SL050,34072424164,385,191,194,98.4536082474227
SL050,34072424165,324,162,162,100
SL050,34072424166,1557,813,744,109.274193548387
SL050,34072424167,801,414,387,106.976744186047
SL050,34072424168,508,276,232,118.965517241379
SL050,34072424169,3157,1569,1588,98.8035264483627
SL050,34072424170,2162,1102,1060,103.962264150943
SL050,34072424171,353,199,154,129.220779220779
SL050,34072424172,413,213,200,106.5
SL050,34072424173,1005,510,495,103.030303030303
SL050,34072424174,503,267,236,113.135593220339
SL050,34072424175,2177,1117,1060,105.377358490566
SL050,34072424176,335,176,159,110.691823899371
SL050,34072424177,509,289,220,131.363636363636
SL050,34072424178,73,33,40,82.5
SL050,34072424179,337,196,141,139.007092198582
SL050,34072424180,1224,652,572,113.986013986014
SL050,34072424181,1661,854,807,105.824039653036
SL050,34072424182,436,214,222,96.3963963963964
SL050,34072424183,853,445,408,109.06862745098
SL050,34072424184,196,109,87,125.287356321839
SL050,34072424185,515,256,259,98.8416988416988
SL050,34072424187,1003,528,475,111.157894736842
SL050,34072424188,5302,2593,2709,95.7179771133259
SL050,34072424189,7294,3768,3526,106.863301191151
SL050,34072424190,159,81,78,103.846153846154
SL050,34072424191,124,76,48,158.333333333333
SL050,34072424193,393,209,184,113.586956521739
SL050,34072424194,284,147,137,107.299270072993
SL050,34072424196,2137,1080,1057,102.175969725639
SL050,34072424197,854,434,420,103.333333333333
SL050,34072424198,604,314,290,108.275862068966
SL050,34072424199,437,241,196,122.959183673469
SL050,34072424201,1117,650,467,139.186295503212
SL050,34072424202,8919,4383,4536,96.6269841269841
SL050,34072424203,93,55,38,144.736842105263
SL050,34072424205,1094,562,532,105.639097744361
SL050,34072424206,1887,928,959,96.7674661105318
SL050,34072424207,336,183,153,119.607843137255
SL050,34072424209,2974,1430,1544,92.6165803108808
SL050,34072424210,588,319,269,118.587360594796
SL050,34072424211,308,170,138,123.188405797101
SL050,34072424212,1155,566,589,96.0950764006791
SL050,34072424213,152,87,65,133.846153846154
SL050,34072424214,696,370,326,113.496932515337
SL050,34072424215,162,82,80,102.5
SL050,34072424216,736,386,350,110.285714285714
SL050,34072424217,158,90,68,132.352941176471
SL050,34072424218,485,256,229,111.7903930131
SL050,34072424219,563,307,256,119.921875
SL050,34072424221,896,455,441,103.174603174603
SL050,34072424222,18676,9223,9453,97.5669099756691
SL050,34072424223,3001,1470,1531,96.0156760287394
SL050,34072424224,615,323,292,110.616438356164
SL050,34072424225,1135,601,534,112.546816479401
SL050,34072424226,196,111,85,130.588235294118
SL050,34072424227,1877,981,896,109.486607142857
SL050,34072424228,673,358,315,113.650793650794
SL050,34072424229,429,250,179,139.664804469274
SL050,34072424230,439,242,197,122.842639593909
SL050,34072424901,936,480,456,105.263157894737
SL050,34072424902,371,185,186,99.4623655913979
SL050,34092525001,181,99,82,120.731707317073
SL050,34092525002,611,324,287,112.891986062718
SL050,34092525003,5393,2700,2693,100.259933160045
SL050,34092525004,796,421,375,112.266666666667
SL050,34092525005,342,174,168,103.571428571429
SL050,34092525006,375,199,176,113.068181818182
SL050,34092525007,2335,1205,1130,106.637168141593
SL050,34092525008,1576,862,714,120.728291316527
SL050,34092525009,762,393,369,106.50406504065
SL050,34092525010,232,118,114,103.508771929825
SL050,34092525011,9422,4876,4546,107.259128904531
SL050,34092525012,3419,1772,1647,107.589556769885
SL050,34092525013,2822,1480,1342,110.283159463487
SL050,34092525014,313,163,150,108.666666666667
SL050,34092525015,399,216,183,118.032786885246
SL050,34092525016,2937,1552,1385,112.057761732852
SL050,34092525017,290,153,137,111.678832116788
SL050,34092525019,6789,3554,3235,109.860896445131
SL050,34092525020,314,174,140,124.285714285714
SL050,34092525021,3453,1824,1629,111.970534069982
SL050,34092525022,131,77,54,142.592592592593
SL050,34092525023,6230,3129,3101,100.902934537246
SL050,34092525024,406,228,178,128.089887640449
SL050,34092525025,1790,928,862,107.656612529002
SL050,34092525027,1328,670,658,101.823708206687
SL050,34092525029,2162,1101,1061,103.770028275212
SL050,34092525030,171,97,74,131.081081081081
SL050,34092525031,63,40,23,173.913043478261
SL050,34092525032,85,48,37,129.72972972973
SL050,34092525033,1538,804,734,109.536784741144
SL050,34092525034,3447,1770,1677,105.545617173524
SL050,34092525035,427,223,204,109.313725490196
SL050,34092525036,217,109,108,100.925925925926
SL050,34092525037,455,261,194,134.536082474227
SL050,34092525038,2545,1328,1217,109.120788824979
SL050,34092525039,330,175,155,112.903225806452
SL050,34092525040,16841,8519,8322,102.367219418409
SL050,34092525041,939,505,434,116.359447004608
SL050,34092525042,231,121,110,110
SL050,34092525043,1022,546,476,114.705882352941
SL050,34092525044,231,113,118,95.7627118644068
SL050,34092525045,64,34,30,113.333333333333
SL050,34092525046,525,265,260,101.923076923077
SL050,34092525047,1252,634,618,102.588996763754
SL050,34092525048,2289,1129,1160,97.3275862068966
SL050,34092525049,193,94,99,94.9494949494949
SL050,34092525050,5060,2635,2425,108.659793814433
SL050,34092525051,1979,1021,958,106.576200417537
SL050,34092525052,2266,1149,1117,102.864816472695
SL050,34092525053,1468,768,700,109.714285714286
SL050,34092525055,181,97,84,115.47619047619
SL050,34092525056,257,139,118,117.796610169492
SL050,34092525057,266,145,121,119.834710743802
SL050,34092525058,6002,3054,2948,103.59565807327
SL050,34092525059,1110,544,566,96.113074204947
SL050,34092525060,76,33,43,76.7441860465116
SL050,34092525061,97,52,45,115.555555555556
SL050,34092525062,842,432,410,105.365853658537
SL050,34092525063,84,48,36,133.333333333333
SL050,34092525064,137,70,67,104.477611940299
SL050,34092525067,931,502,429,117.016317016317
SL050,34092525068,687,361,326,110.736196319018
SL050,34092525069,538,290,248,116.935483870968
SL050,34092525070,1000,496,504,98.4126984126984
SL050,34092525071,46,28,18,155.555555555556
SL050,34092525072,9066,4594,4472,102.728085867621
SL050,34092525073,648,345,303,113.861386138614
SL050,34092525074,206,109,97,112.371134020619
SL050,34092525075,147,74,73,101.369863013699
SL050,34092525076,161,88,73,120.547945205479
SL050,34092525077,549,284,265,107.169811320755
SL050,34092525078,1431,777,654,118.807339449541
SL050,34092525079,358,184,174,105.747126436782
SL050,34092525081,357,181,176,102.840909090909
SL050,34092525082,352,190,162,117.283950617284
SL050,34092525085,160,85,75,113.333333333333
SL050,34092525086,756,363,393,92.3664122137405
SL050,34092525087,69,36,33,109.090909090909
SL050,34092525088,119,69,50,138
SL050,34092525089,122,69,53,130.188679245283
SL050,34092525092,154,83,71,116.901408450704
SL050,34092525093,792,388,404,96.039603960396
SL050,34092525094,173,103,70,147.142857142857
SL050,34092525096,1217,606,611,99.1816693944353
SL050,34092525097,84,43,41,104.878048780488
SL050,34092525098,274,133,141,94.3262411347518
SL050,34092525099,1864,937,927,101.078748651564
SL050,34092525100,209,120,89,134.831460674157
SL050,34092525101,728,388,340,114.117647058824
SL050,34092525102,956,519,437,118.764302059497
SL050,34092525103,140,79,61,129.508196721311
SL050,34092525104,147,76,71,107.042253521127
SL050,34092525105,144,87,57,152.631578947368
SL050,34092525109,270,146,124,117.741935483871
SL050,34092525110,7034,3746,3288,113.929440389294
SL050,34092525111,138,88,50,176
SL050,34092525112,337,174,163,106.748466257669
SL050,34092525113,1557,817,740,110.405405405405
SL050,34092525114,104,57,47,121.276595744681
SL050,34092525115,1028,546,482,113.278008298755
SL050,34092525118,393,211,182,115.934065934066
SL050,34092525119,3409,1785,1624,109.913793103448
SL050,34092525120,137856,68070,69786,97.5410540796148
SL050,34092525121,954,480,474,101.26582278481
SL050,34092525122,2660,1340,1320,101.515151515152
SL050,34092525123,227,111,116,95.6896551724138
SL050,34092525124,179,95,84,113.095238095238
SL050,34092525125,460,239,221,108.144796380091
SL050,34092525126,352,171,181,94.475138121547
SL050,34092525127,255,146,109,133.94495412844
SL050,34092525128,142,86,56,153.571428571429
SL050,34092525129,195,107,88,121.590909090909
SL050,34092525130,225,115,110,104.545454545455
SL050,34092525131,585,334,251,133.067729083665
SL050,34092525132,232,122,110,110.909090909091
SL050,34092525133,931,511,420,121.666666666667
SL050,34092525134,801,450,351,128.205128205128
SL050,34092525135,1347,676,671,100.745156482861
SL050,34092525136,109,54,55,98.1818181818182
SL050,34092525137,14740,7543,7197,104.807558705016
SL050,34092525138,635,327,308,106.168831168831
SL050,34092525139,554,307,247,124.291497975709
SL050,34092525140,1074,578,496,116.532258064516
SL050,34092525141,190,105,85,123.529411764706
SL050,34092525142,469,236,233,101.287553648069
SL050,34092525143,98,46,52,88.4615384615385
SL050,34092525145,93,52,41,126.829268292683
SL050,34092525146,291,147,144,102.083333333333
SL050,34092525148,260,153,107,142.990654205607
SL050,34092525149,1787,900,887,101.465614430665
SL050,34092525150,202,108,94,114.893617021277
SL050,34092525151,961,508,453,112.141280353201
SL050,34092525152,172,90,82,109.756097560976
SL050,34092525153,212,114,98,116.326530612245
SL050,34092525154,134,73,61,119.672131147541
SL050,34092525155,792,396,396,100
SL050,34092525156,1009,512,497,103.018108651911
SL050,34092525157,205,104,101,102.970297029703
SL050,34092525158,2163,1070,1093,97.8956999085087
SL050,34092525161,428,220,208,105.769230769231
SL050,34092525163,265,160,105,152.380952380952
SL050,34092525164,462,266,196,135.714285714286
SL050,34092525165,353,175,178,98.314606741573
SL050,34092525166,203,119,84,141.666666666667
SL050,34092525167,298,155,143,108.391608391608
SL050,34092525168,626,325,301,107.97342192691
SL050,34092525169,191,107,84,127.380952380952
SL050,34092525170,301,160,141,113.475177304965
SL050,34092525171,2939,1448,1491,97.1160295103957
SL050,34092525172,2604,1299,1305,99.5402298850575
SL050,34092525173,2216,1107,1109,99.819657348963
SL050,34092525174,703,399,304,131.25
SL050,34092525175,231,121,110,110
SL050,34092525176,385,198,187,105.882352941176
SL050,34092525177,428,217,211,102.843601895735
SL050,34092525179,224,109,115,94.7826086956522
SL050,34092525180,272,136,136,100
SL050,34092525181,231,131,100,131
SL050,34092525182,1363,700,663,105.580693815988
SL050,34092525183,663,338,325,104
SL050,34092525185,923,478,445,107.415730337079
SL050,34092525186,261,130,131,99.236641221374
SL050,34092525189,3130,1571,1559,100.769724182168
SL050,34092525190,324,174,150,116
SL050,34092525191,393,206,187,110.160427807487
SL050,34092525192,1040,546,494,110.526315789474
SL050,34092525193,934,457,477,95.8071278825996
SL050,34092525194,495,262,233,112.44635193133
SL050,34092525196,129,78,51,152.941176470588
SL050,34092525197,177,101,76,132.894736842105
SL050,34092525200,361,198,163,121.472392638037
SL050,34092525201,120,69,51,135.294117647059
SL050,34092525202,139,80,59,135.593220338983
SL050,34092525203,12041,5834,6207,93.9906557112937
SL050,34092525204,1889,1012,877,115.39338654504
SL050,34092525205,733,385,348,110.632183908046
SL050,34092525206,328,175,153,114.37908496732
SL050,34092525207,9014,4465,4549,98.1534403165531
SL050,34092525208,399,215,184,116.847826086957
SL050,34092525209,2164,1076,1088,98.8970588235294
SL050,34092525210,1764,926,838,110.501193317422
SL050,34092525211,851,470,381,123.359580052493
SL050,34092525212,355,208,147,141.496598639456
SL050,34092525215,651,456,195,233.846153846154
SL050,34092525216,247,142,105,135.238095238095
SL050,34092525217,16795,8323,8472,98.2412653446648
SL050,34092525218,99,53,46,115.217391304348
SL050,34092525219,183,100,83,120.481927710843
SL050,34092525220,1383,705,678,103.982300884956
SL050,34092525221,134,66,68,97.0588235294118
SL050,34092525222,74,38,36,105.555555555556
SL050,34092525223,1244,624,620,100.645161290323
SL050,34092525224,151,83,68,122.058823529412
SL050,34092525225,879,473,406,116.502463054187
SL050,34092525226,289,153,136,112.5
SL050,34092525227,747,379,368,102.989130434783
SL050,34092525228,4630,2353,2277,103.337725076856
SL050,34092525230,2190,1124,1066,105.440900562852
SL050,34092525231,742,426,316,134.810126582278
SL050,34092525232,2307,1195,1112,107.464028776978
SL050,34092525233,386,202,184,109.782608695652
SL050,34092525234,5824,2847,2977,95.6331877729258
SL050,34092525238,234,123,111,110.810810810811
SL050,34092525239,803,418,385,108.571428571429
SL050,34092525240,1884,942,942,100
SL050,34092525242,905,434,471,92.1443736730361
SL050,34092525243,5493,2787,2706,102.993348115299
SL050,34092525244,510,261,249,104.819277108434
SL050,34092525245,536,281,255,110.196078431373
SL050,34092525247,159,90,69,130.434782608696
SL050,34092525248,1170,582,588,98.9795918367347
SL050,34092525249,202,101,101,100
SL050,34092525250,395,225,170,132.352941176471
SL050,34092525251,945,494,451,109.534368070953
SL050,34092525252,717,358,359,99.7214484679666
SL050,34092525253,168,85,83,102.409638554217
SL050,34092525254,1039,531,508,104.527559055118
SL050,34092525255,482,252,230,109.565217391304
SL050,34092525901,372,195,177,110.169491525424
SL050,34092525902,648,337,311,108.360128617363
SL050,34092525903,298,160,138,115.942028985507
SL050,34092525904,165,91,74,122.972972972973
SL050,34092525905,422,215,207,103.864734299517
SL050,34092525906,272,151,121,124.793388429752
SL050,34092525907,590,316,274,115.328467153285
SL050,34092525908,253,141,112,125.892857142857
SL050,34092525909,168,87,81,107.407407407407
SL050,34092525910,118,66,52,126.923076923077
SL050,34092525911,507,269,238,113.025210084034
SL050,34092525912,1108,587,521,112.667946257198
SL050,34092525913,94,55,39,141.025641025641
SL050,34172626001,255,150,105,142.857142857143
SL050,34172626002,1105,599,506,118.379446640316
SL050,34172626003,470,233,237,98.3122362869198
SL050,34172626004,62,44,18,244.444444444444
SL050,34172626005,3462,1762,1700,103.647058823529
SL050,34172626006,2433,1229,1204,102.076411960133
SL050,34172626007,644,338,306,110.457516339869
SL050,34172626008,2732,1427,1305,109.348659003831
SL050,34172626009,502,269,233,115.450643776824
SL050,34172626010,102,61,41,148.780487804878
SL050,34172626011,9460,4763,4697,101.405152224824
SL050,34172626012,28,16,12,133.333333333333
SL050,34172626013,434,237,197,120.304568527919
SL050,34172626014,509,287,222,129.279279279279
SL050,34172626015,226,117,109,107.339449541284
SL050,34172626016,30,20,10,200
SL050,34172626017,426,210,216,97.2222222222222
SL050,34172626018,14815,7373,7442,99.0728298844397
SL050,34172626019,488,261,227,114.977973568282
SL050,34172626020,754,399,355,112.394366197183
SL050,34172626021,4469,2218,2251,98.533984895602
SL050,34172626022,200,106,94,112.765957446809
SL050,34172626023,502,256,246,104.065040650407
SL050,34172626024,234,124,110,112.727272727273
SL050,34172626025,86,53,33,160.606060606061
SL050,34172626026,1590,792,798,99.2481203007519
SL050,34172626027,159,101,58,174.137931034483
SL050,34172626028,142,78,64,121.875
SL050,34172626029,39,21,18,116.666666666667
SL050,34172626030,19,9,10,90
SL050,34172626031,104,53,51,103.921568627451
SL050,34172626032,51,30,21,142.857142857143
SL050,34172626033,201,89,112,79.4642857142857
SL050,34172626034,766,409,357,114.565826330532
SL050,34172626035,20,14,6,233.333333333333
SL050,34172626036,23923,11741,12182,96.3799047775406
SL050,34172626037,151,82,69,118.840579710145
SL050,34172626038,85,57,28,203.571428571429
SL050,34172626039,40,20,20,100
SL050,34172626040,97,51,46,110.869565217391
SL050,34172626041,147,80,67,119.402985074627
SL050,34172626042,1145,583,562,103.73665480427
SL050,34172626043,424,204,220,92.7272727272727
SL050,34172626044,50,30,20,150
SL050,34172626045,12,5,7,71.4285714285714
SL050,34172626046,2036,1043,993,105.03524672709
SL050,34172626047,2298,1193,1105,107.963800904977
SL050,34172626048,24,12,12,100
SL050,34172626049,197,106,91,116.483516483516
SL050,34172626050,142,92,50,184
SL050,34172626051,273,162,111,145.945945945946
SL050,34172626052,157,78,79,98.7341772151899
SL050,34172626053,252,132,120,110
SL050,34172626054,319,185,134,138.059701492537
SL050,34172626055,39,23,16,143.75
SL050,34172626056,488,266,222,119.81981981982
SL050,34172626057,47,32,15,213.333333333333
SL050,34172626058,167,103,64,160.9375
SL050,34172626059,1519,800,719,111.265646731572
SL050,34172626060,93,62,31,200
SL050,34172626061,2027,1045,982,106.415478615071
SL050,34172626062,96,55,41,134.146341463415
SL050,34172626063,134,85,49,173.469387755102
SL050,34172626064,3108,1569,1539,101.949317738791
SL050,34172626065,50,32,18,177.777777777778
SL050,34172626066,332,168,164,102.439024390244
SL050,34172626067,18,12,6,200
SL050,34172626068,116,63,53,118.867924528302
SL050,34172626069,255,146,109,133.94495412844
SL050,34172626070,179,92,87,105.747126436782
SL050,34172626071,11309,5543,5766,96.1325008671523
SL050,34172626072,330,172,158,108.860759493671
SL050,34172626073,110,60,50,120
SL050,34172626074,120,62,58,106.896551724138
SL050,34172626075,440,236,204,115.686274509804
SL050,34172626076,130,66,64,103.125
SL050,34172626077,18,8,10,80
SL050,34172626078,92,53,39,135.897435897436
SL050,34172626079,818,443,375,118.133333333333
SL050,34172626080,608,344,264,130.30303030303
SL050,34172626081,18,10,8,125
SL050,34172626082,116,71,45,157.777777777778
SL050,34172626083,293,161,132,121.969696969697
SL050,34172626084,10193,5124,5069,101.085026632472
SL050,34172626086,15,12,3,400
SL050,34172626087,238,123,115,106.95652173913
SL050,34172626088,33,18,15,120
SL050,34172626089,151113,71860,79253,90.6716464991862
SL050,34172626091,168,111,57,194.736842105263
SL050,34172626092,117,72,45,160
SL050,34172626093,55,41,14,292.857142857143
SL050,34172626094,72,42,30,140
SL050,34172626095,93,49,44,111.363636363636
SL050,34172626096,321,174,147,118.367346938776
SL050,34172626098,108,61,47,129.787234042553
SL050,34172626099,1654,847,807,104.956629491945
SL050,34172626100,59,34,25,136
SL050,34172626101,39,23,16,143.75
SL050,34172626102,8047,3948,4099,96.3161746767504
SL050,34172626103,988,528,460,114.782608695652
SL050,34172626104,15,10,5,200
SL050,34172626105,2952,1500,1452,103.305785123967
SL050,34172626106,86,48,38,126.315789473684
SL050,34172626107,92,61,31,196.774193548387
SL050,34172626108,282,173,109,158.715596330275
SL050,34172626109,82,49,33,148.484848484849
SL050,34172626110,175,105,70,150
SL050,34172626111,286,151,135,111.851851851852
SL050,34172626112,246,145,101,143.564356435644
SL050,34172626113,31,24,7,342.857142857143
SL050,34172626114,76,53,23,230.434782608696
SL050,34172626115,15,9,6,150
SL050,34172626117,3822,1954,1868,104.603854389722
SL050,34172626118,71,36,35,102.857142857143
SL050,34172626119,217,121,96,126.041666666667
SL050,34172626120,2032,1065,967,110.134436401241
SL050,34172626121,32,23,9,255.555555555556
SL050,34172626122,130,67,63,106.349206349206
SL050,34172626123,138,77,61,126.229508196721
SL050,34172626124,961,503,458,109.825327510917
SL050,34172626125,3722,1892,1830,103.387978142077
SL050,34172626126,29,19,10,190
SL050,34172626127,229,122,107,114.018691588785
SL050,34172626128,130,65,65,100
SL050,34172626129,1124,598,526,113.688212927757
SL050,34172626130,222,149,73,204.109589041096
SL050,34172626131,35,24,11,218.181818181818
SL050,34172626132,142,85,57,149.122807017544
SL050,34172626134,88,55,33,166.666666666667
SL050,34172626135,154,99,55,180
SL050,34172626136,107,58,49,118.367346938776
SL050,34172626138,6231,3123,3108,100.482625482625
SL050,34172626139,64,32,32,100
SL050,34172626140,288,153,135,113.333333333333
SL050,34172626141,109,68,41,165.853658536585
SL050,34172626142,1015,529,486,108.847736625514
SL050,34172626143,296,167,129,129.457364341085
SL050,34172626144,232,135,97,139.175257731959
SL050,34172626145,297,167,130,128.461538461538
SL050,34172626146,87,50,37,135.135135135135
SL050,34172626147,30,16,14,114.285714285714
SL050,34172626148,186,93,93,100
SL050,34172626149,47,28,19,147.368421052632
SL050,34172626150,139,81,58,139.655172413793
SL050,34172626151,464,253,211,119.905213270142
SL050,34172626152,30,19,11,172.727272727273
SL050,34172626153,10,8,2,400
SL050,34172626154,10,6,4,150
SL050,34172626155,168,91,77,118.181818181818
SL050,34172626157,358,177,181,97.7900552486188
SL050,34172626158,359,195,164,118.90243902439
SL050,34172626160,988,504,484,104.132231404959
SL050,34172626161,8,5,3,166.666666666667
SL050,34172626162,133,81,52,155.769230769231
SL050,34172626163,169,87,82,106.09756097561
SL050,34172626164,59,33,26,126.923076923077
SL050,34172626165,390,220,170,129.411764705882
SL050,34172626166,154,95,59,161.016949152542
SL050,34172626167,67,44,23,191.304347826087
SL050,34172626168,7973,4019,3954,101.643904906424
SL050,34172626169,72,40,32,125
SL050,34172626170,597,309,288,107.291666666667
SL050,34172626171,163,98,65,150.769230769231
SL050,34172626172,27,21,6,350
SL050,34172626173,5,3,2,150
SL050,34172626174,140,83,57,145.614035087719
SL050,34172626175,48,31,17,182.352941176471
SL050,34172626176,57,32,25,128
SL050,34172626177,325,199,126,157.936507936508
SL050,34172626178,78,45,33,136.363636363636
SL050,34172626179,42,29,13,223.076923076923
SL050,34172626180,258,141,117,120.512820512821
SL050,34172626181,14,10,4,250
SL050,34172626183,91,45,46,97.8260869565217
SL050,34122727001,2428,1195,1233,96.9180859691809
SL050,34122727002,1757,847,910,93.0769230769231
SL050,34122727003,2008,985,1023,96.2854349951124
SL050,34122727004,1268,672,596,112.751677852349
SL050,34122727005,2941,1408,1533,91.8460534898891
SL050,34122727006,2827,1422,1405,101.209964412811
SL050,34122727007,3037,1527,1510,101.12582781457
SL050,34122727008,1503,777,726,107.02479338843
SL050,34122727009,2235,1126,1109,101.532912533814
SL050,34122727010,5011,2468,2543,97.0507274872198
SL050,34122727011,2675,1382,1293,106.883217324053
SL050,34122727012,1377,788,589,133.786078098472
SL050,34122727013,4227,2076,2151,96.513249651325
SL050,34122727014,3487,1768,1719,102.850494473531
SL050,34122727015,4596,2226,2370,93.9240506329114
SL050,34122727016,8324,4024,4300,93.5813953488372
SL050,34122727017,1018,529,489,108.179959100205
SL050,34122727018,3589,1867,1722,108.420441347271
SL050,34122727019,10002,4865,5137,94.7050807864512
SL050,34122727020,3772,1903,1869,101.819154628143
SL050,34122727021,1841,892,949,93.9936775553214
SL050,34122727022,5505,2739,2766,99.0238611713666
SL050,34122727023,2718,1393,1325,105.132075471698
SL050,34122727024,1609,806,803,100.373599003736
SL050,34122727025,3314,1647,1667,98.8002399520096
SL050,34122727026,2637,1338,1299,103.002309468822
SL050,34122727027,2181,1059,1122,94.3850267379679
SL050,34122727028,98025,45456,52569,86.4692118929407
SL050,34122727029,1711,852,859,99.1850989522701
SL050,34122727030,3639,1712,1927,88.8427607680332
SL050,34122727031,18599,8827,9772,90.3295128939828
SL050,34122727032,3667,1827,1840,99.2934782608696
SL050,34122727033,636,314,322,97.5155279503106
SL050,34122727034,1103,622,481,129.313929313929
SL050,34122727035,218,112,106,105.660377358491
SL050,34122727037,1114,591,523,113.001912045889
SL050,34122727038,1018,517,501,103.193612774451
SL050,34122727039,5093,2624,2469,106.27784528149
SL050,34122727040,3414,1731,1683,102.852049910873
SL050,34122727041,2539,1232,1307,94.2616679418516
SL050,34122727042,1820,916,904,101.327433628319
SL050,34122727043,1388,693,695,99.7122302158273
SL050,34122727044,3056,1543,1513,101.982815598149
SL050,34122727045,1032,563,469,120.042643923241
SL050,34122727046,1616,800,816,98.0392156862745
SL050,34122727047,1685,842,843,99.8813760379597
SL050,34122727048,2283,1104,1179,93.6386768447837
SL050,34122727049,1487,767,720,106.527777777778
SL050,34122727050,3257,1559,1698,91.8138987043581
SL050,34122727051,9900,4733,5167,91.6005419005225
SL050,34122727052,970,483,487,99.1786447638604
SL050,34122727053,543,278,265,104.905660377358
SL050,34122727054,1255,616,639,96.4006259780908
SL050,34122727055,1293,691,602,114.784053156146
SL050,34122727056,1501,755,746,101.206434316354
SL050,34122727057,13345,6524,6821,95.6457997361091
SL050,34122727058,3743,1889,1854,101.887810140237
SL050,34122727059,2301,1133,1168,97.0034246575343
SL050,34122727060,2830,1341,1489,90.0604432505037
SL050,34122727061,1121,546,575,94.9565217391304
SL050,34122727062,643,317,326,97.239263803681
SL050,34122727063,2004,963,1041,92.507204610951
SL050,34122727064,1723,844,879,96.0182025028441
SL050,34122727065,14226,6894,7332,94.0261865793781
SL050,34122727066,15510,7606,7904,96.2297570850202
SL050,34122727901,2566,1348,1218,110.673234811166
SL050,34122727902,9566,4753,4813,98.753376272595
SL050,34132828001,65,35,30,116.666666666667
SL050,34132828002,4559,2374,2185,108.649885583524
SL050,34132828003,195,117,78,150
SL050,34132828004,9353,4617,4736,97.4873310810811
SL050,34132828005,193751,94359,99392,94.9362121699936
SL050,34132828006,116037,55613,60424,92.0379319475705
SL050,34132828007,169502,81750,87752,93.1602698513994
SL050,34132828008,2698,1408,1290,109.147286821705
SL050,34132828009,20473,10091,10382,97.1970718551339
SL050,34132828010,14364,7037,7327,96.0420363040808
SL050,34132828011,601,301,300,100.333333333333
SL050,34132828012,1272,661,611,108.183306055646
SL050,34132828013,59037,28775,30262,95.0862467781376
SL050,34132828014,54554,27377,27177,100.735916399897
SL050,34132828015,30052,15097,14955,100.949515212304
SL050,34132828016,93,53,40,132.5
SL050,34132828017,1638,840,798,105.263157894737
SL050,34132828018,5564,2787,2777,100.360100828232
SL050,34132828019,1627,861,766,112.402088772846
SL050,34132828020,198,115,83,138.55421686747
SL050,34132828021,741,379,362,104.696132596685
SL050,34132828022,52626,25703,26923,95.4685584815957
SL050,34132828023,7399,3724,3675,101.333333333333
SL050,34132828024,205,122,83,146.987951807229
SL050,34132828025,525,302,223,135.42600896861
SL050,34132828026,10596,5209,5387,96.6957490254316
SL050,34132828027,1875,910,965,94.300518134715
SL050,34132828028,2486,1240,1246,99.5184590690209
SL050,34132828029,712,365,347,105.187319884726
SL050,34132828030,2613,1281,1332,96.1711711711712
SL050,34132828031,3049,1595,1454,109.697386519945
SL050,34132828032,7226,3658,3568,102.522421524664
SL050,34132828033,6075,3058,3017,101.358965860126
SL050,34132828034,423,227,196,115.816326530612
SL050,34132828035,1905,947,958,98.8517745302714
SL050,34132828036,3707,1877,1830,102.568306010929
SL050,34132828037,1980,977,1003,97.40777666999
SL050,34132828038,6948,3403,3545,95.9943582510578
SL050,34132828039,149,89,60,148.333333333333
SL050,34132828040,24087,12125,11962,101.362648386557
SL050,34132828041,7280,3594,3686,97.5040694519805
SL050,34132828042,1685,881,804,109.577114427861
SL050,34132828043,7902,4002,3900,102.615384615385
SL050,34132828044,9124,4464,4660,95.793991416309
SL050,34132828045,49498,24456,25042,97.6599313153901
SL050,34132828046,6781,3358,3423,98.1010809231668
SL050,34132828047,63074,30723,32351,94.9676980618837
SL050,34132828048,697,364,333,109.309309309309
SL050,34132828049,81860,40106,41754,96.0530727594961
SL050,34132828050,6310,3128,3182,98.3029541169076
SL050,34132828051,2240,1137,1103,103.082502266546
SL050,34132828052,5239,2641,2598,101.655119322556
SL050,34132828053,10061,5009,5052,99.1488519398258
SL050,34132828054,15842,7821,8021,97.5065453185388
SL050,34132828055,1236,636,600,106
SL050,34132828056,1554,785,769,102.080624187256
SL050,34132828057,2181,1137,1044,108.908045977012
SL050,34132828058,193586,95433,98153,97.2288162358766
SL050,34132828059,6541,3319,3222,103.010552451893
SL050,34132828060,1985,1003,982,102.13849287169
SL050,34132828061,33379,16373,17006,96.2777843114195
SL050,34132828062,348,191,157,121.656050955414
SL050,34132828063,318,174,144,120.833333333333
SL050,34132828064,188,109,79,137.974683544304
SL050,34132828065,180747,88464,92283,95.8616429894997
SL050,34132828066,10178,5048,5130,98.401559454191
SL050,34132828067,6119,3089,3030,101.947194719472
SL050,34132828068,15785,7779,8006,97.1646265301024
SL050,34132828069,48,32,16,200
SL050,34132828070,148,82,66,124.242424242424
SL050,34132828071,89,46,43,106.976744186047
SL050,34132828072,8222,4125,4097,100.68342689773
SL050,34132828073,19587,9838,9749,100.912914145041
SL050,34132828074,188425,91463,96962,94.328706091046
SL050,34132828075,8673,4359,4314,101.043115438108
SL050,34132828076,559,294,265,110.943396226415
SL050,34132828078,47,31,16,193.75
SL050,34132828079,3223334,1500190,1723144,87.0612090457907
SL050,34132828080,71785,34020,37765,90.0834105653383
SL050,34132828082,8597,4358,4239,102.807265864591
SL050,34132828083,13959,7052,6907,102.099319530911
SL050,34132828084,23241,11551,11690,98.8109495295124
SL050,34132828085,5897,3041,2856,106.477591036415
SL050,34132828086,8666,4384,4282,102.382064455862
SL050,34132828087,4328,2145,2183,98.2592762253779
SL050,34132828088,363,186,177,105.084745762712
SL050,34132828089,5021,2501,2520,99.2460317460317
SL050,34132828090,12697,6342,6355,99.7954366640441
SL050,34132828091,7553,3768,3785,99.550858652576
SL050,34132828092,207095,100930,106165,95.0689963735694
SL050,34132828093,2911,1445,1466,98.5675306957708
SL050,34132828094,1397,717,680,105.441176470588
SL050,34132828095,2601,1342,1259,106.59253375695
SL050,34132828096,28305,14148,14157,99.9364272091545
SL050,34132828097,122,77,45,171.111111111111
SL050,34132828099,2819,1500,1319,113.722517058378
SL050,34132828100,6154,3124,3030,103.102310231023
SL050,34132828101,346,183,163,112.269938650307
SL050,34132828102,1202,612,590,103.728813559322
SL050,34132828104,24521,12396,12125,102.235051546392
SL050,34132828106,128256,63838,64418,99.0996305380484
SL050,34132828107,523,251,272,92.2794117647059
SL050,34132828108,5746,2880,2866,100.488485694348
SL050,34132828109,2475,1260,1215,103.703703703704
SL050,34132828110,2831,1431,1400,102.214285714286
SL050,34132828111,821,426,395,107.848101265823
SL050,34132828112,187,111,76,146.052631578947
SL050,34132828113,51541,25524,26017,98.1050851366414
SL050,34132828114,171,91,80,113.75
SL050,34132828115,86172,41290,44882,91.9967915868277
SL050,34132828116,1120,592,528,112.121212121212
SL050,34132828117,117,68,49,138.775510204082
SL050,34132828118,60,36,24,150
SL050,34132828119,3357,1695,1662,101.985559566787
SL050,34132828120,1663,913,750,121.733333333333
SL050,34132828121,247,131,116,112.931034482759
SL050,34132828122,706,358,348,102.873563218391
SL050,34132828123,85893,42616,43277,98.4726298033598
SL050,34132828124,87,46,41,112.19512195122
SL050,34132828125,4159,2164,1995,108.471177944862
SL050,34132828126,48,29,19,152.631578947368
SL050,34132828127,95550,46246,49304,93.7976634755801
SL050,34132828128,527,300,227,132.15859030837
SL050,34132828129,13273,6506,6767,96.1430471405349
SL050,34132828130,39466,19207,20259,94.8072461621995
SL050,34132828131,18088,8660,9428,91.8540517607128
SL050,34132828132,18784,9569,9215,103.841562669561
SL050,34132828133,8318,4133,4185,98.7574671445639
SL050,34132828134,87724,42854,44870,95.5070202808112
SL050,34132828135,1182,619,563,109.946714031972
SL050,34132828136,850,427,423,100.945626477541
SL050,34132828137,2542,1288,1254,102.711323763955
SL050,34132828138,74,40,34,117.647058823529
SL050,34132828140,4066,2025,2041,99.2160705536502
SL050,34132828141,9095,4451,4644,95.8440999138674
SL050,34132828143,80,46,34,135.294117647059
SL050,34132828144,8694,4268,4426,96.4301852688658
SL050,34132828145,3725,1850,1875,98.6666666666667
SL050,34132828146,2604,1333,1271,104.878048780488
SL050,34132828147,1304,671,633,106.003159557662
SL050,34132828148,129729,63910,65819,97.0996216897856
SL050,34132828149,8582,4246,4336,97.9243542435424
SL050,34132828150,4298,2131,2167,98.338717120443
SL050,34132828151,4724,2389,2335,102.312633832976
SL050,34132828152,23361,11239,12122,92.7157234779739
SL050,34132828153,975,497,478,103.97489539749
SL050,34132828154,7760,3956,3804,103.995793901157
SL050,34132828155,626,321,305,105.245901639344
SL050,34132828156,1510,783,727,107.702888583219
SL050,34132828157,903,449,454,98.8986784140969
SL050,34132828158,927,496,431,115.08120649652
SL050,34132828159,761,396,365,108.493150684932
SL050,34132828160,12280,6183,6097,101.410529768739
SL050,34132828161,74745,36984,37761,97.9423214427584
SL050,34132828162,4039,2077,1962,105.861365953109
SL050,34132828163,574,310,264,117.424242424242
SL050,34132828164,4384,2233,2151,103.812180381218
SL050,34132828165,2840,1469,1371,107.148067104303
SL050,34132828166,432,224,208,107.692307692308
SL050,34132828167,12193,6146,6047,101.637175458905
SL050,34132828168,1942,1013,929,109.041980624327
SL050,34132828169,2081,1102,979,112.563840653728
SL050,34132828170,3363,1712,1651,103.694730466384
SL050,34132828171,6409,3233,3176,101.794710327456
SL050,34132828172,13421,6785,6636,102.245328511151
SL050,34132828173,699,353,346,102.023121387283
SL050,34132828174,2501,1274,1227,103.830480847596
SL050,34132828175,1420,700,720,97.2222222222222
SL050,34132828176,21000,10238,10762,95.1310165396766
SL050,34132828177,17127,8331,8796,94.7135061391542
SL050,34132828178,1547,789,758,104.089709762533
SL050,34132828179,1967,983,984,99.8983739837398
SL050,34132828180,7291,3674,3617,101.575891622892
SL050,34132828181,27596,13352,14244,93.7377141252457
SL050,34132828182,258,141,117,120.512820512821
SL050,34132828183,1620,847,773,109.573091849935
SL050,34132828901,1266,656,610,107.540983606557
SL050,34132828902,642,348,294,118.367346938776
SL050,34132828903,46750,22694,24056,94.3382108413701
SL050,34012929001,5366,2716,2650,102.490566037736
SL050,34012929002,2239,1148,1091,105.224564619615
SL050,34012929003,1105,575,530,108.490566037736
SL050,34012929004,394,204,190,107.368421052632
SL050,34012929005,6367,3191,3176,100.472292191436
SL050,34012929006,778,411,367,111.989100817439
SL050,34012929007,39911,19830,20081,98.750062247896
SL050,34012929008,24123,12066,12057,100.074645434188
SL050,34012929009,1802,930,872,106.651376146789
SL050,34012929010,1984,1013,971,104.3254376931
SL050,34012929011,3770,1950,1820,107.142857142857
SL050,34012929012,12951,6533,6418,101.791835462761
SL050,34012929013,2015,1029,986,104.361054766734
SL050,34012929014,252,129,123,104.878048780488
SL050,34012929015,41154,20161,20993,96.0367741628162
SL050,34012929016,391,200,191,104.712041884817
SL050,34012929017,8288,4233,4055,104.389642416769
SL050,34012929018,2493,1272,1221,104.176904176904
SL050,34012929019,1177,619,558,110.931899641577
SL050,34012929020,4147,2051,2096,97.8530534351145
SL050,34012929021,169,91,78,116.666666666667
SL050,34012929022,225,110,115,95.6521739130435
SL050,34012929023,7989,4024,3965,101.488020176545
SL050,34012929024,443,227,216,105.092592592593
SL050,34012929025,67746,33385,34361,97.1595704432351
SL050,34012929026,1496,772,724,106.629834254144
SL050,34012929027,2999,1511,1488,101.545698924731
SL050,34012929028,1488,775,713,108.695652173913
SL050,34012929029,458,229,229,100
SL050,34012929030,933,490,443,110.609480812641
SL050,34012929031,1823,934,889,105.061867266592
SL050,34012929032,8517,4319,4198,102.882324916627
SL050,34012929033,1620,861,759,113.438735177866
SL050,34012929034,732,363,369,98.3739837398374
SL050,34012929035,1691,849,842,100.83135391924
SL050,34012929036,748,391,357,109.52380952381
SL050,34012929037,247,133,114,116.666666666667
SL050,34012929038,25758,13011,12747,102.071075547188
SL050,34012929039,3507,1822,1685,108.13056379822
SL050,34012929040,2510,1336,1174,113.798977853492
SL050,34012929041,6121,3151,2970,106.094276094276
SL050,34012929042,21716,10911,10805,100.981027302175
SL050,34012929043,3392,1743,1649,105.700424499697
SL050,34012929044,1323,719,604,119.039735099338
SL050,34012929045,3745,1872,1873,99.9466097170315
SL050,34012929046,3181,1636,1545,105.88996763754
SL050,34012929047,1392,694,698,99.4269340974212
SL050,34012929048,1595,791,804,98.3830845771144
SL050,34012929049,3671,1849,1822,101.481888035126
SL050,34012929050,614,317,297,106.734006734007
SL050,34012929051,67012,32918,34094,96.5507127353787
SL050,34012929052,248,127,121,104.95867768595
SL050,34012929053,3086,1558,1528,101.96335078534
SL050,34012929054,75396,36690,38706,94.7915051929933
SL050,34012929055,2554,1306,1248,104.647435897436
SL050,34012929056,1573,827,746,110.857908847185
SL050,34012929057,393,199,194,102.577319587629
SL050,34012929058,2182,1090,1092,99.8168498168498
SL050,34012929059,3310,1647,1663,99.0378833433554
SL050,34012929060,762,381,381,100
SL050,34012929061,1458,729,729,100
SL050,34012929062,863,446,417,106.954436450839
SL050,34012929063,376,190,186,102.150537634409
SL050,34012929064,559,283,276,102.536231884058
SL050,34012929065,225,130,95,136.842105263158
SL050,34012929066,442,235,207,113.526570048309
SL050,34012929067,571026,274373,296653,92.4895416530424
SL050,34012929068,14977,7651,7326,104.436254436254
SL050,34012929069,141463,68073,73390,92.7551437525548
SL050,34012929070,80630,40267,40363,99.7621584124074
SL050,34012929071,1230,642,588,109.183673469388
SL050,34012929072,5020,2526,2494,101.283079390537
SL050,34012929073,2523,1296,1227,105.623471882641
SL050,34012929074,970,476,494,96.3562753036437
SL050,34012929075,21061,10397,10664,97.4962490622656
SL050,34012929076,3568,1820,1748,104.118993135011
SL050,34012929077,253,125,128,97.65625
SL050,34012929079,3068,1614,1454,111.004126547455
SL050,34012929080,9118,4600,4518,101.814962372731
SL050,34012929081,294,153,141,108.510638297872
SL050,34012929082,46093,22646,23447,96.5837847059325
SL050,34012929083,2701,1423,1278,111.345852895149
SL050,34012929084,33978,16530,17448,94.7386519944979
SL050,34012929085,174,89,85,104.705882352941
SL050,34012929086,1658,849,809,104.944375772559
SL050,34012929087,606,344,262,131.297709923664
SL050,34012929088,3356,1698,1658,102.412545235223
SL050,34012929089,3818,1927,1891,101.903754627181
SL050,34012929090,2083,1057,1026,103.021442495127
SL050,34012929091,16465,8374,8091,103.497713508837
SL050,34012929092,715,376,339,110.914454277286
SL050,34012929093,2568,1303,1265,103.00395256917
SL050,34012929094,80817,39900,40917,97.5144805337635
SL050,34012929095,4218,2170,2048,105.95703125
SL050,34012929096,3373,1647,1726,95.422943221321
SL050,34012929097,5300,2663,2637,100.985968904058
SL050,34012929098,1490,756,734,102.99727520436
SL050,34012929099,2020,1051,969,108.462332301342
SL050,34012929100,2880,1467,1413,103.821656050955
SL050,34012929901,68262,34079,34183,99.6957551999532
SL050,34012929902,3288,1609,1679,95.8308516974389
SL050,34012929903,585,313,272,115.073529411765
SL050,34012929904,477,241,236,102.118644067797
SL050,34143030001,6063,3060,3003,101.898101898102
SL050,34143030002,13030,6527,6503,100.369060433646
SL050,34143030003,35031,17490,17541,99.7092526081751
SL050,34143030004,1361,689,672,102.529761904762
SL050,34143030005,41622,20539,21083,97.4197220509415
SL050,34143030006,1022,508,514,98.8326848249027
SL050,34143030007,9525,4896,4629,105.767984445885
SL050,34143030008,21657,10934,10723,101.967732910566
SL050,34143030009,19053,9978,9075,109.950413223141
SL050,34143030010,11274,5819,5455,106.672777268561
SL050,34143030011,6564,3354,3210,104.485981308411
SL050,34143030012,11547,5804,5743,101.06216263277
SL050,34143030013,10165,5158,5007,103.015777910925
SL050,34143030014,2045,973,1072,90.7649253731343
SL050,34143030015,25730,12859,12871,99.9067671509595
SL050,34143030016,213943,106701,107242,99.4955334663658
SL050,34143030017,15022,7550,7472,101.043897216274
SL050,34143030018,11565,5824,5741,101.445741160077
SL050,34143030019,34889,17486,17403,100.476929265069
SL050,34143030020,10060,5363,4697,114.179263359591
SL050,34143030021,16184,8459,7725,109.501618122977
SL050,34143030022,25547,13334,12213,109.178743961353
SL050,34143030023,5196,2654,2542,104.405979543666
SL050,34143030024,93079,47660,45419,104.934058433695
SL050,34143030025,7002,3543,3459,102.428447528187
SL050,34143030026,31562,16308,15254,106.909663039203
SL050,34143030027,70964,35392,35572,99.493984032385
SL050,34143030028,7954,4051,3903,103.791954906482
SL050,34143030029,16790,8619,8171,105.482805042222
SL050,34143030030,447182,218511,228671,95.5569355099685
SL050,34143030031,500,262,238,110.084033613445
SL050,34143030032,3842,1989,1853,107.339449541284
SL050,34143030033,14981,7519,7462,100.763870276065
SL050,34143030034,1301,688,613,112.234910277325
SL050,34143030035,31905,16033,15872,101.014364919355
SL050,34143030036,25167,12733,12434,102.404696799099
SL050,34143030037,35614,18542,17072,108.610590440487
SL050,34143030038,21375,10868,10507,103.435804701627
SL050,34143030039,31639,16299,15340,106.251629726206
SL050,34143030040,879,451,428,105.373831775701
SL050,34143030041,19907,10085,9822,102.677662390552
SL050,34143030042,2758,1387,1371,101.167031363968
SL050,34143030043,34234,17157,17077,100.46846635826
SL050,34143030901,16105,8093,8012,101.010983524713
SL050,34143030902,15674,7994,7680,104.088541666667
SL050,34153131001,87,51,36,141.666666666667
SL050,34153131002,550,269,281,95.729537366548
SL050,34153131003,121,76,45,168.888888888889
SL050,34153131004,33,20,13,153.846153846154
SL050,34153131005,356,193,163,118.40490797546
SL050,34153131006,2483,1260,1223,103.025347506132
SL050,34153131007,156,87,69,126.086956521739
SL050,34153131008,72,40,32,125
SL050,34153131009,791,421,370,113.783783783784
SL050,34153131010,7407,3740,3667,101.990728115626
SL050,34153131011,850,455,395,115.189873417722
SL050,34153131012,983,490,493,99.3914807302231
SL050,34153131013,730,391,339,115.339233038348
SL050,34153131014,340,192,148,129.72972972973
SL050,34153131015,2715,1356,1359,99.7792494481236
SL050,34153131016,10739,5285,5454,96.9013568023469
SL050,34153131017,485,258,227,113.656387665198
SL050,34153131018,568,312,256,121.875
SL050,34153131019,2624,1330,1294,102.782071097372
SL050,34153131020,525,292,233,125.321888412017
SL050,34153131021,70,40,30,133.333333333333
SL050,34153131022,614,324,290,111.724137931034
SL050,34153131023,10512,5296,5216,101.533742331288
SL050,34153131024,116,63,53,118.867924528302
SL050,34153131025,949,493,456,108.114035087719
SL050,34153131026,157,84,73,115.068493150685
SL050,34153131027,1124,573,551,103.992740471869
SL050,34153131028,264,143,121,118.181818181818
SL050,34153131029,1117,551,566,97.3498233215548
SL050,34153131030,157,85,72,118.055555555556
SL050,34153131031,275,143,132,108.333333333333
SL050,34153131032,2315,1187,1128,105.230496453901
SL050,34153131033,53,30,23,130.434782608696
SL050,34153131034,36,19,17,111.764705882353
SL050,34153131035,55,31,24,129.166666666667
SL050,34153131036,1047,555,492,112.80487804878
SL050,34153131037,106,57,49,116.326530612245
SL050,34153131038,1669,847,822,103.041362530414
SL050,34153131039,118,60,58,103.448275862069
SL050,34153131040,212,119,93,127.956989247312
SL050,34153131041,2331,1214,1117,108.683974932856
SL050,34153131042,3853,1967,1886,104.294803817603
SL050,34153131043,32,13,19,68.4210526315789
SL050,34153131044,345,180,165,109.090909090909
SL050,34153131045,639,346,293,118.088737201365
SL050,34153131046,58,28,30,93.3333333333333
SL050,34153131047,262,126,136,92.6470588235294
SL050,34153131048,219,117,102,114.705882352941
SL050,34153131049,839,478,361,132.409972299169
SL050,34153131050,7749,3920,3829,102.376599634369
SL050,34153131051,275,146,129,113.178294573643
SL050,34153131052,125,62,63,98.4126984126984
SL050,34153131053,610,313,297,105.387205387205
SL050,34153131054,607,295,312,94.5512820512821
SL050,34153131055,352,187,165,113.333333333333
SL050,34153131056,204,113,91,124.175824175824
SL050,34153131057,2223,1087,1136,95.6866197183099
SL050,34153131058,242,120,122,98.3606557377049
SL050,34153131059,208,119,89,133.707865168539
SL050,34153131060,18934,9152,9782,93.5595992639542
SL050,34153131061,57,26,31,83.8709677419355
SL050,34153131062,1364,720,644,111.801242236025
SL050,34153131063,97,55,42,130.952380952381
SL050,34153131064,1993,1021,972,105.041152263374
SL050,34153131065,2702,1423,1279,111.258795934324
SL050,34153131066,1039,523,516,101.356589147287
SL050,34153131067,2455,1245,1210,102.892561983471
SL050,34153131068,3818,1889,1929,97.9263867288751
SL050,34153131069,980,490,490,100
SL050,34153131070,4109,2041,2068,98.6943907156673
SL050,34153131071,17,13,4,325
SL050,34153131072,7823,4013,3810,105.328083989501
SL050,34153131073,361,186,175,106.285714285714
SL050,34153131074,490,260,230,113.04347826087
SL050,34153131075,141,66,75,88
SL050,34153131076,3850,1976,1874,105.442902881537
SL050,34153131077,7707,3884,3823,101.595605545383
SL050,34153131078,3148,1588,1560,101.794871794872
SL050,34153131079,75,43,32,134.375
SL050,34153131080,599,308,291,105.841924398625
SL050,34153131081,431,215,216,99.537037037037
SL050,34153131082,805,428,377,113.527851458886
SL050,34153131083,77,37,40,92.5
SL050,34153131084,2503,1303,1200,108.583333333333
SL050,34153131085,633,331,302,109.602649006623
SL050,34153131086,20774,10457,10317,101.356983619269
SL050,34153131087,219,111,108,102.777777777778
SL050,34153131088,8224,4143,4081,101.5192354815
SL050,34153131089,298,157,141,111.347517730496
SL050,34153131090,152,93,59,157.627118644068
SL050,34153131091,384,205,179,114.525139664804
SL050,34153131092,789,441,348,126.724137931034
SL050,34153131093,306,165,141,117.021276595745
SL050,34153131094,119,58,61,95.0819672131148
SL050,34153131095,76,40,36,111.111111111111
SL050,34153131096,103,57,46,123.913043478261
SL050,34153131097,13673,6555,7118,92.0904748524867
SL050,34153131098,2600,1348,1252,107.667731629393
SL050,34153131099,65,36,29,124.137931034483
SL050,34153131100,284,160,124,129.032258064516
SL050,34153131101,1804,935,869,107.594936708861
SL050,34153131102,150,98,52,188.461538461538
SL050,34153131103,42,21,21,100
SL050,34153131104,2306,1167,1139,102.458296751536
SL050,34153131105,2017,1020,997,102.306920762287
SL050,34153131106,983,495,488,101.434426229508
SL050,34153131107,2485,1328,1157,114.779602420052
SL050,34153131108,2487,1228,1259,97.537728355838
SL050,34153131109,2213,1164,1049,110.962821734986
SL050,34153131110,100,56,44,127.272727272727
SL050,34153131111,95,63,32,196.875
SL050,34153131112,89,52,37,140.540540540541
SL050,34153131113,146,89,57,156.140350877193
SL050,34153131114,479,252,227,111.013215859031
SL050,34153131115,189,99,90,110
SL050,34153131116,74,46,28,164.285714285714
SL050,34153131117,705,377,328,114.939024390244
SL050,34153131118,163,107,56,191.071428571429
SL050,34153131119,40,23,17,135.294117647059
SL050,34153131120,444,263,181,145.303867403315
SL050,34153131121,78,41,37,110.810810810811
SL050,34153131122,7014,3542,3472,102.016129032258
SL050,34153131123,805,426,379,112.401055408971
SL050,34153131124,253,148,105,140.952380952381
SL050,34153131125,325,171,154,111.038961038961
SL050,34153131126,425,227,198,114.646464646465
SL050,34153131127,176,95,81,117.283950617284
SL050,34153131128,420,209,211,99.0521327014218
SL050,34153131129,504,258,246,104.878048780488
SL050,34153131130,382,193,189,102.116402116402
SL050,34153131131,1199,649,550,118
SL050,34153131132,176,115,61,188.524590163934
SL050,34153131133,44,27,17,158.823529411765
SL050,34153131134,191,107,84,127.380952380952
SL050,34153131135,106,30,76,39.4736842105263
SL050,34153131136,550,298,252,118.253968253968
SL050,34153131137,227,132,95,138.947368421053
SL050,34153131138,1272,668,604,110.596026490066
SL050,34153131139,172,98,74,132.432432432432
SL050,34153131140,147,88,59,149.152542372881
SL050,34153131141,119,67,52,128.846153846154
SL050,34153131142,2060,1087,973,111.716341212744
SL050,34153131143,103,51,52,98.0769230769231
SL050,34153131144,967,525,442,118.778280542986
SL050,34153131145,187,95,92,103.260869565217
SL050,34153131146,31,18,13,138.461538461538
SL050,34153131147,113,63,50,126
SL050,34153131148,110,49,61,80.327868852459
SL050,34153131149,2898,1505,1393,108.040201005025
SL050,34153131150,232,146,86,169.767441860465
SL050,34153131151,60,38,22,172.727272727273
SL050,34153131152,1725,891,834,106.834532374101
SL050,34153131153,2735,1414,1321,107.040121120363
SL050,34153131154,242,145,97,149.484536082474
SL050,34153131155,291,145,146,99.3150684931507
SL050,34153131156,297,173,124,139.516129032258
SL050,34153131157,4764,2414,2350,102.723404255319
SL050,34153131158,294,158,136,116.176470588235
SL050,34153131159,1317,716,601,119.134775374376
SL050,34153131160,130,70,60,116.666666666667
SL050,34153131161,437,233,204,114.21568627451
SL050,34153131162,52,26,26,100
SL050,34153131163,2862,1440,1422,101.26582278481
SL050,34153131164,747,384,363,105.785123966942
SL050,34153131165,3534,1815,1719,105.584642233857
SL050,34153131166,292,152,140,108.571428571429
SL050,34153131167,1057,554,503,110.13916500994
SL050,34153131168,277,155,122,127.049180327869
SL050,34153131169,3397,1766,1631,108.277130594727
SL050,34153131170,56,27,29,93.1034482758621
SL050,34153131171,850,442,408,108.333333333333
SL050,34153131172,466,253,213,118.779342723005
SL050,34153131173,1088,541,547,98.9031078610603
SL050,34153131174,120,60,60,100
SL050,34153131175,77,41,36,113.888888888889
SL050,34153131176,4088,2055,2033,101.082144613871
SL050,34153131177,327,173,154,112.337662337662
SL050,34153131178,646,339,307,110.42345276873
SL050,34153131179,639,340,299,113.71237458194
SL050,34153131180,239,101,138,73.1884057971015
SL050,34153131181,142,85,57,149.122807017544
SL050,34153131182,34,20,14,142.857142857143
SL050,34153131183,912,459,453,101.324503311258
SL050,34153131184,77,39,38,102.631578947368
SL050,34153131185,530,284,246,115.447154471545
SL050,34153131186,369,202,167,120.958083832335
SL050,34153131187,121,72,49,146.938775510204
SL050,34153131188,363,207,156,132.692307692308
SL050,34153131189,1497,762,735,103.673469387755
SL050,34153131190,51,28,23,121.739130434783
SL050,34153131191,3931,1991,1940,102.628865979381
SL050,34153131192,204,112,92,121.739130434783
SL050,34153131193,1842,915,927,98.705501618123
SL050,34153131194,415,224,191,117.277486910995
SL050,34153131195,197,98,99,98.989898989899
SL050,34153131196,36,19,17,111.764705882353
SL050,34153131197,79,44,35,125.714285714286
SL050,34153131198,48,25,23,108.695652173913
SL050,34153131199,147,85,62,137.096774193548
SL050,34153131200,919,490,429,114.219114219114
SL050,34153131201,199066,94124,104942,89.6914486097082
SL050,34153131202,5823,2930,2893,101.278949187694
SL050,34153131203,31,18,13,138.461538461538
SL050,34153131204,37,24,13,184.615384615385
SL050,34153131205,493,248,245,101.224489795918
SL050,34153131206,2843,1437,1406,102.204836415363
SL050,34153131207,349,192,157,122.292993630573
SL050,34153131208,3742,1956,1786,109.518477043673
SL050,34153131209,174,94,80,117.5
SL050,34153131210,208,108,100,108
SL050,34153131211,21,11,10,110
SL050,34153131212,144,79,65,121.538461538462
SL050,34153131213,116,66,50,132
SL050,34153131214,110,62,48,129.166666666667
SL050,34153131215,6241,3097,3144,98.5050890585242
SL050,34153131216,4960,2523,2437,103.528929011079
SL050,34153131217,398,203,195,104.102564102564
SL050,34153131219,100,55,45,122.222222222222
SL050,34153131220,886,461,425,108.470588235294
SL050,34153131221,1729,883,846,104.373522458629
SL050,34153131222,62,40,22,181.818181818182
SL050,34153131223,1294,669,625,107.04
SL050,34153131224,1180,606,574,105.574912891986
SL050,34153131225,57,34,23,147.826086956522
SL050,34153131226,671,350,321,109.034267912773
SL050,34153131227,10605,5222,5383,97.0091027308193
SL050,34153131228,598,307,291,105.498281786942
SL050,34153131229,42,27,15,180
SL050,34153131230,104,54,50,108
SL050,34153131231,122,59,63,93.6507936507936
SL050,34153131232,35593,17497,18096,96.6898762157383
SL050,34153131233,134,59,75,78.6666666666667
SL050,34153131234,177,99,78,126.923076923077
SL050,34153131235,177,102,75,136
SL050,34153131236,1655,857,798,107.393483709273
SL050,34153131237,212,121,91,132.967032967033
SL050,34153131238,137,72,65,110.769230769231
SL050,34153131239,355,175,180,97.2222222222222
SL050,34153131240,675,347,328,105.792682926829
SL050,34153131241,133,87,46,189.130434782609
SL050,34153131242,308,138,170,81.1764705882353
SL050,34153131243,374,198,176,112.5
SL050,34153131244,180,103,77,133.766233766234
SL050,34153131245,88,56,32,175
SL050,34153131246,164,92,72,127.777777777778
SL050,34153131247,160,82,78,105.128205128205
SL050,34153131248,358,206,152,135.526315789474
SL050,34153131249,2373,1186,1187,99.9157540016849
SL050,34153131250,3761,1855,1906,97.3242392444911
SL050,34153131251,4156,2099,2057,102.041808458921
SL050,34153131252,95,52,43,120.93023255814
SL050,34153131253,171,93,78,119.230769230769
SL050,34153131254,2841,1423,1418,100.352609308886
SL050,34153131255,120,64,56,114.285714285714
SL050,34153131256,106,57,49,116.326530612245
SL050,34153131257,1186,595,591,100.676818950931
SL050,34153131258,10150,4970,5180,95.945945945946
SL050,34153131259,622,325,297,109.427609427609
SL050,34153131260,1508,785,723,108.575380359613
SL050,34153131261,297,174,123,141.463414634146
SL050,34153131262,295,160,135,118.518518518519
SL050,34153131263,316,164,152,107.894736842105
SL050,34153131264,225,112,113,99.1150442477876
SL050,34153131265,112,70,42,166.666666666667
SL050,34153131901,20039,9674,10365,93.3333333333333
SL050,34153131902,7011,3583,3428,104.521586931155
SL050,34153131903,10167,5129,5038,101.80627233029
SL050,34153131904,2209,1138,1071,106.2558356676
SL050,34153131905,3941,1932,2009,96.1672473867596
SL050,34153131906,3996,2008,1988,101.006036217304
SL050,34153131907,14891,7285,7606,95.7796476465948
SL050,34153131908,1535,762,773,98.5769728331177
SL050,34123232001,6110,3078,3032,101.517150395778
SL050,34123232002,2265,1129,1136,99.3838028169014
SL050,34123232003,995,496,499,99.3987975951904
SL050,34123232004,1806,831,975,85.2307692307692
SL050,34123232005,968,525,443,118.510158013544
SL050,34123232006,1591,771,820,94.0243902439024
SL050,34123232007,1547,773,774,99.8708010335917
SL050,34123232008,10951,5343,5608,95.274607703281
SL050,34123232009,13463,6552,6911,94.8053827231949
SL050,34123232010,404,215,189,113.756613756614
SL050,34123232011,973,428,545,78.5321100917431
SL050,34123232012,809,442,367,120.435967302452
SL050,34123232013,2299,1094,1205,90.7883817427386
SL050,34123232014,1199,567,632,89.7151898734177
SL050,34123232015,917,467,450,103.777777777778
SL050,34123232016,779,382,397,96.2216624685139
SL050,34123232017,1574,813,761,106.833114323259
SL050,34123232018,1317,637,680,93.6764705882353
SL050,34123232019,13939,6539,7400,88.3648648648649
SL050,34123232020,2643,1294,1349,95.9229058561898
SL050,34123232021,1001,509,492,103.455284552846
SL050,34123232022,1380,690,690,100
SL050,34123232023,1224,622,602,103.322259136213
SL050,34123232024,5533,2626,2907,90.3336773305814
SL050,34123232025,1140,568,572,99.3006993006993
SL050,34123232026,3049,1534,1515,101.254125412541
SL050,34123232027,1105,533,572,93.1818181818182
SL050,34123232028,1700,870,830,104.819277108434
SL050,34123232029,466,262,204,128.43137254902
SL050,34123232030,1166,551,615,89.5934959349594
SL050,34123232031,1134,577,557,103.59066427289
SL050,34123232032,9836,4763,5073,93.8892174255864
SL050,34123232033,750,361,389,92.8020565552699
SL050,34123232034,1308,681,627,108.612440191388
SL050,34123232035,1477,709,768,92.3177083333333
SL050,34123232036,1418,717,701,102.28245363766
SL050,34123232037,741,366,375,97.6
SL050,34123232038,455,220,235,93.6170212765958
SL050,34123232039,1287,666,621,107.246376811594
SL050,34123232040,1583,761,822,92.5790754257907
SL050,34123232041,807,383,424,90.3301886792453
SL050,34123232042,1732,868,864,100.462962962963
SL050,34123232043,2890,1417,1473,96.1982348947726
SL050,34123232044,890,435,455,95.6043956043956
SL050,34123232045,2767,1353,1414,95.6859971711457
SL050,34123232046,1227,587,640,91.71875
SL050,34123232047,1911,932,979,95.1991828396323
SL050,34123232048,1039,537,502,106.972111553785
SL050,34123232049,722,376,346,108.670520231214
SL050,34123232050,2602,1337,1265,105.691699604743
SL050,34123232051,1486,758,728,104.120879120879
SL050,34123232052,2011,1017,994,102.313883299799
SL050,34123232053,1766,961,805,119.378881987578
SL050,34123232054,105505,47962,57543,83.349842726309
SL050,34123232055,1383,689,694,99.2795389048991
SL050,34123232056,1759,849,910,93.2967032967033
SL050,34123232057,564,307,257,119.455252918288
SL050,34123232058,6254,3205,3049,105.116431616924
SL050,34123232059,1871,920,951,96.7402733964248
SL050,34123232060,889,435,454,95.8149779735683
SL050,34123232061,1140,576,564,102.127659574468
SL050,34123232062,830,404,426,94.8356807511737
SL050,34123232063,2118,1063,1055,100.758293838863
SL050,34123232064,554,276,278,99.2805755395683
SL050,34123232065,699,344,355,96.9014084507042
SL050,34123232066,611,268,343,78.134110787172
SL050,34123232067,1282,654,628,104.140127388535
SL050,34123232068,1540,703,837,83.9904420549582
SL050,34123232069,5028,2453,2575,95.2621359223301
SL050,34123232070,549,271,278,97.4820143884892
SL050,34123232071,1568,802,766,104.699738903394
SL050,34123232072,4359,2138,2221,96.2629446195407
SL050,34123232073,1448,705,743,94.885598923284
SL050,34123232074,1091,532,559,95.169946332737
SL050,34123232075,5249,2660,2589,102.742371572036
SL050,34123232076,2191,1075,1116,96.326164874552
SL050,34123232077,1213,561,652,86.0429447852761
SL050,34123232078,1189,598,591,101.184433164129
SL050,34123232079,1443,741,702,105.555555555556
SL050,34123232080,332,167,165,101.212121212121
SL050,34123232081,2368,1219,1149,106.09225413403
SL050,34123232082,1288,645,643,100.311041990669
SL050,34123232083,904,463,441,104.988662131519
SL050,34123232084,933,447,486,91.9753086419753
SL050,34123232085,13817,6634,7183,92.3569539189754
SL050,34123232086,2929,1480,1449,102.139406487233
SL050,34123232087,1904,974,930,104.731182795699
SL050,34123232088,1746,894,852,104.929577464789
SL050,34123232089,1317,675,642,105.140186915888
SL050,34123232090,829,404,425,95.0588235294118
SL050,34123232091,1912,999,913,109.419496166484
SL050,34123232092,535,311,224,138.839285714286
SL050,34033333001,1697,854,843,101.304863582444
SL050,34033333002,10808,5326,5482,97.1543232396935
SL050,34033333003,675,379,296,128.040540540541
SL050,34033333004,78715,37191,41524,89.5650708024275
SL050,34033333005,1522,795,727,109.353507565337
SL050,34033333006,1700,810,890,91.0112359550562
SL050,34033333007,1571,791,780,101.410256410256
SL050,34033333008,2002,1021,981,104.07747196738
SL050,34033333009,1035,514,521,98.6564299424184
SL050,34033333010,1985,974,1011,96.3402571711177
SL050,34033333011,12579,6196,6383,97.0703430988563
SL050,34033333012,6278,3033,3245,93.4668721109399
SL050,34033333013,477,242,235,102.978723404255
SL050,34033333014,10444,5043,5401,93.3715978522496
SL050,34033333015,1553,881,672,131.10119047619
SL050,34033333016,22464,10894,11570,94.1573033707865
SL050,34033333017,3470,1689,1781,94.8343627175744
SL050,34033333018,3336,1627,1709,95.2018724400234
SL050,34033333019,3332,1636,1696,96.4622641509434
SL050,34033333020,15721,7730,7991,96.733825553748
SL050,34033333021,5078,2505,2573,97.3571706179557
SL050,34033333022,949,493,456,108.114035087719
SL050,34033333023,3830,1882,1948,96.611909650924
SL050,34033333024,271843,128208,143635,89.2595815783061
SL050,34033333025,10427,5088,5339,95.2987450833489
SL050,34033333026,9839,4748,5091,93.2626203103516
SL050,34033333027,853,439,414,106.038647342995
SL050,34033333028,1301,736,565,130.265486725664
SL050,34033333029,352,175,177,98.8700564971751
SL050,34033333030,1022,516,506,101.97628458498
SL050,34033333031,39984,19051,20933,91.0094109778818
SL050,34033333032,13087,6269,6818,91.947785274274
SL050,34033333033,11086,5339,5747,92.9006438141639
SL050,34033333034,11734,5730,6004,95.4363757495003
SL050,34033333035,13676,6783,6893,98.4041781517482
SL050,34033333036,13639,6621,7018,94.3431176973497
SL050,34033333037,38428,18237,20191,90.3224208805904
SL050,34033333038,2631,1320,1311,100.686498855835
SL050,34033333039,1846,883,963,91.6926272066459
SL050,34033333040,5334,2624,2710,96.8265682656827
SL050,34033333041,8409,4043,4366,92.6019239578562
SL050,34033333042,5167,2481,2686,92.3678332092331
SL050,34033333043,740,401,339,118.289085545723
SL050,34033333044,220020,101906,118114,86.2776639517754
SL050,34033333045,5353,2626,2727,96.2962962962963
SL050,34033333046,531,279,252,110.714285714286
SL050,34033333047,1246,610,636,95.9119496855346
SL050,34033333048,146,81,65,124.615384615385
SL050,34033333049,7101,3503,3598,97.3596442468038
SL050,34033333050,598,354,244,145.081967213115
SL050,34033333051,8282,3998,4284,93.3239962651727
SL050,34033333052,737,425,312,136.217948717949
SL050,34033333053,1194,691,503,137.375745526839
SL050,34033333054,1865,964,901,106.992230854606
SL050,34033333055,1758,845,913,92.552026286966
SL050,34033333056,5730,2738,2992,91.5106951871658
SL050,34033333057,1857,929,928,100.10775862069
SL050,34033333058,1933,971,962,100.935550935551
SL050,34033333059,5084,2512,2572,97.6671850699844
SL050,34033333060,16283,7785,8498,91.6097905389503
SL050,34033333061,393,194,199,97.4874371859297
SL050,34033333062,453,235,218,107.798165137615
SL050,34033333063,433,212,221,95.9276018099548
SL050,34033333064,288,142,146,97.2602739726027
SL050,34033333065,1254,604,650,92.9230769230769
SL050,34033333066,51662,25234,26428,95.4820644770698
SL050,34033333067,818,434,384,113.020833333333
SL050,34033333068,1125,650,475,136.842105263158
SL050,34033333069,3887,1919,1968,97.510162601626
SL050,34033333070,3795,1846,1949,94.7152385838892
SL050,34033333071,646,308,338,91.1242603550296
SL050,34033333072,1628,871,757,115.059445178336
SL050,34033333073,9543,4815,4728,101.840101522843
SL050,34033333074,3866,1862,2004,92.9141716566866
SL050,34033333075,298,150,148,101.351351351351
SL050,34033333076,14430,7120,7310,97.4008207934337
SL050,34033333077,1248,649,599,108.347245409015
SL050,34033333078,140,78,62,125.806451612903
SL050,34073434001,42,26,16,162.5
SL050,34073434003,164,91,73,124.657534246575
SL050,34073434004,6842,3312,3530,93.8243626062323
SL050,34073434005,928,453,475,95.3684210526316
SL050,34073434006,86,46,40,115
SL050,34073434009,35,22,13,169.230769230769
SL050,34073434010,622,319,303,105.280528052805
SL050,34073434011,423,234,189,123.809523809524
SL050,34073434012,369,196,173,113.294797687861
SL050,34073434015,42,26,16,162.5
SL050,34073434017,1004,506,498,101.606425702811
SL050,34073434018,221,125,96,130.208333333333
SL050,34073434019,131,71,60,118.333333333333
SL050,34073434020,52,32,20,160
SL050,34073434022,1216,641,575,111.478260869565
SL050,34073434023,6363,3195,3168,100.852272727273
SL050,34073434024,28,18,10,180
SL050,34073434025,53,24,29,82.7586206896552
SL050,34073434027,1183,589,594,99.1582491582492
SL050,34073434028,144,77,67,114.925373134328
SL050,34073434029,754,392,362,108.28729281768
SL050,34073434031,33,18,15,120
SL050,34073434032,41,22,19,115.789473684211
SL050,34073434033,17,13,4,325
SL050,34073434034,115,65,50,130
SL050,34073434035,111,65,46,141.304347826087
SL050,34073434036,246,140,106,132.075471698113
SL050,34073434037,264,147,117,125.641025641026
SL050,34073434038,306,167,139,120.143884892086
SL050,34073434039,61,37,24,154.166666666667
SL050,34073434041,92,43,49,87.7551020408163
SL050,34073434042,326,182,144,126.388888888889
SL050,34073434045,77,40,37,108.108108108108
SL050,34073434046,43,25,18,138.888888888889
SL050,34073434047,2096,996,1100,90.5454545454545
SL050,34073434048,63,30,33,90.9090909090909
SL050,34073434049,360,193,167,115.568862275449
SL050,34073434050,220,124,96,129.166666666667
SL050,34073434051,101,53,48,110.416666666667
SL050,34073434052,183,100,83,120.481927710843
SL050,34073434053,230,119,111,107.207207207207
SL050,34073434055,262,144,118,122.033898305085
SL050,34073434056,2316,1165,1151,101.216333622937
SL050,34073434057,490,243,247,98.3805668016194
SL050,34073434058,198,112,86,130.232558139535
SL050,34073434059,448,220,228,96.4912280701754
SL050,34073434060,139,76,63,120.634920634921
SL050,34073434061,105,61,44,138.636363636364
SL050,34073434062,165,101,64,157.8125
SL050,34073434063,93,55,38,144.736842105263
SL050,34073434066,63,36,27,133.333333333333
SL050,34073434067,136,78,58,134.48275862069
SL050,34073434068,42,25,17,147.058823529412
SL050,34073434069,2633,1343,1290,104.108527131783
SL050,34073434070,149,79,70,112.857142857143
SL050,34073434071,179,94,85,110.588235294118
SL050,34073434072,153,75,78,96.1538461538462
SL050,34073434073,194,97,97,100
SL050,34073434074,770,397,373,106.434316353887
SL050,34073434076,659,340,319,106.583072100313
SL050,34073434077,429,226,203,111.330049261084
SL050,34073434079,2269,1184,1085,109.124423963134
SL050,34073434080,6153,3057,3096,98.7403100775194
SL050,34073434081,58,36,22,163.636363636364
SL050,34073434082,78,41,37,110.810810810811
SL050,34073434083,2006,977,1029,94.9465500485909
SL050,34073434084,146,83,63,131.746031746032
SL050,34073434086,103,53,50,106
SL050,34073434087,143,78,65,120
SL050,34073434088,313,180,133,135.338345864662
SL050,34073434089,157,88,69,127.536231884058
SL050,34073434091,136,77,59,130.508474576271
SL050,34073434092,291,154,137,112.408759124088
SL050,34073434093,98,57,41,139.024390243902
SL050,34073434094,63,36,27,133.333333333333
SL050,34073434096,51,32,19,168.421052631579
SL050,34073434098,993,528,465,113.548387096774
SL050,34073434099,82,44,38,115.789473684211
SL050,34073434100,144,81,63,128.571428571429
SL050,34073434101,41,19,22,86.3636363636364
SL050,34073434102,217,126,91,138.461538461538
SL050,34073434103,102,62,40,155
SL050,34073434104,259,148,111,133.333333333333
SL050,34073434106,122,66,56,117.857142857143
SL050,34073434107,74,42,32,131.25
SL050,34073434108,610,318,292,108.904109589041
SL050,34073434109,59,35,24,145.833333333333
SL050,34073434110,82,46,36,127.777777777778
SL050,34073434112,46,25,21,119.047619047619
SL050,34073434113,39,14,25,56
SL050,34073434114,198,121,77,157.142857142857
SL050,34073434116,57,32,25,128
SL050,34073434120,78629,37076,41553,89.2258080042356
SL050,34073434121,211,120,91,131.868131868132
SL050,34073434122,121,68,53,128.301886792453
SL050,34073434123,1930,986,944,104.449152542373
SL050,34073434124,66,39,27,144.444444444444
SL050,34073434125,88,43,45,95.5555555555556
SL050,34073434126,324,180,144,125
SL050,34073434127,90,49,41,119.512195121951
SL050,34073434129,179,108,71,152.112676056338
SL050,34073434130,220,114,106,107.547169811321
SL050,34073434131,61,32,29,110.344827586207
SL050,34073434132,131,72,59,122.033898305085
SL050,34073434133,110,64,46,139.130434782609
SL050,34073434134,42,23,19,121.052631578947
SL050,34073434135,463,260,203,128.07881773399
SL050,34073434136,184,109,75,145.333333333333
SL050,34073434137,24,16,8,200
SL050,34073434139,194,102,92,110.869565217391
SL050,34073434140,105,57,48,118.75
SL050,34073434141,252,142,110,129.090909090909
SL050,34073434143,184,110,74,148.648648648649
SL050,34073434146,53,35,18,194.444444444444
SL050,34073434147,198,109,89,122.47191011236
SL050,34073434149,21,10,11,90.9090909090909
SL050,34073434151,154,90,64,140.625
SL050,34073434152,151,82,69,118.840579710145
SL050,34073434154,80,46,34,135.294117647059
SL050,34073434155,146,73,73,100
SL050,34073434156,52,34,18,188.888888888889
SL050,34073434157,3004,1528,1476,103.523035230352
SL050,34073434158,317,165,152,108.552631578947
SL050,34073434159,433,238,195,122.051282051282
SL050,34073434160,162,88,74,118.918918918919
SL050,34073434161,23,14,9,155.555555555556
SL050,34073434163,51,26,25,104
SL050,34073434165,65,38,27,140.740740740741
SL050,34073434167,120,68,52,130.769230769231
SL050,34073434168,52,32,20,160
SL050,34073434169,459,259,200,129.5
SL050,34073434170,54,30,24,125
SL050,34073434171,1044,514,530,96.9811320754717
SL050,34073434174,197,109,88,123.863636363636
SL050,34073434175,100,62,38,163.157894736842
SL050,34073434176,145,86,59,145.762711864407
SL050,34073434177,191,109,82,132.926829268293
SL050,34073434178,137,73,64,114.0625
SL050,34073434179,25,15,10,150
SL050,34073434180,71,37,34,108.823529411765
SL050,34073434181,490,260,230,113.04347826087
SL050,34073434182,968,526,442,119.004524886878
SL050,34073434184,45,25,20,125
SL050,34073434185,64,35,29,120.689655172414
SL050,34073434186,47,25,22,113.636363636364
SL050,34073434189,61,36,25,144
SL050,34073434190,51,28,23,121.739130434783
SL050,34073434192,96,57,39,146.153846153846
SL050,34073434196,88,52,36,144.444444444444
SL050,34073434199,1299,666,633,105.21327014218
SL050,34073434201,184,99,85,116.470588235294
SL050,34073434202,32,18,14,128.571428571429
SL050,34073434204,48,28,20,140
SL050,34073434205,63,36,27,133.333333333333
SL050,34073434206,963,491,472,104.025423728814
SL050,34073434208,58,34,24,141.666666666667
SL050,34073434210,104,52,52,100
SL050,34073434211,193,97,96,101.041666666667
SL050,34073434213,57,31,26,119.230769230769
SL050,34073434214,196,104,92,113.04347826087
SL050,34073434215,169,88,81,108.641975308642
SL050,34073434216,66,39,27,144.444444444444
SL050,34073434217,1652,832,820,101.463414634146
SL050,34073434218,589,333,256,130.078125
SL050,34073434220,177,99,78,126.923076923077
SL050,34073434221,175,97,78,124.358974358974
SL050,34073434222,118,64,54,118.518518518519
SL050,34073434223,235,138,97,142.268041237113
SL050,34073434224,45,30,15,200
SL050,34073434225,6503,3360,3143,106.904231625835
SL050,34073434227,75,37,38,97.3684210526316
SL050,34073434228,90,51,39,130.769230769231
SL050,34073434229,62,41,21,195.238095238095
SL050,34073434230,16,11,5,220
SL050,34073434231,207,111,96,115.625
SL050,34073434232,826,451,375,120.266666666667
SL050,34073434233,143,84,59,142.372881355932
SL050,34073434234,71,48,23,208.695652173913
SL050,34073434236,155,82,73,112.328767123288
SL050,34073434237,665,335,330,101.515151515152
SL050,34073434238,365,177,188,94.1489361702128
SL050,34073434240,97,52,45,115.555555555556
SL050,34073434241,17,10,7,142.857142857143
SL050,34073434242,109,57,52,109.615384615385
SL050,34073434243,369,194,175,110.857142857143
SL050,34073434245,327,183,144,127.083333333333
SL050,34073434246,75,39,36,108.333333333333
SL050,34073434901,1225,654,571,114.535901926445
SL050,34073434902,174,107,67,159.701492537313
SL050,34073434903,198,114,84,135.714285714286
SL050,34073434904,320,184,136,135.294117647059
SL050,34053535001,5573,2783,2790,99.7491039426523
SL050,34053535002,31152,15777,15375,102.614634146341
SL050,34053535003,11948,6370,5578,114.198637504482
SL050,34053535004,61351,30724,30627,100.316714010514
SL050,34053535005,1090,589,501,117.564870259481
SL050,34053535006,37691,18735,18956,98.8341422240979
SL050,34053535007,731,385,346,111.271676300578
SL050,34053535008,7491,3766,3725,101.10067114094
SL050,34053535009,24209,12118,12091,100.22330659168
SL050,34053535010,4969,2532,2437,103.898235535494
SL050,34053535011,30831,15532,15299,101.522975357867
SL050,34053535012,19657,10146,9511,106.676479865419
SL050,34053535013,7728,3933,3795,103.636363636364
SL050,34053535014,25884,13505,12379,109.096049761693
SL050,34053535015,20539,10661,9878,107.926705810893
SL050,34053535016,378517,183034,195483,93.6316712962253
SL050,34053535017,39382,19989,19393,103.073273861703
SL050,34053535018,18327,9181,9146,100.382680953422
SL050,34053535019,53588,27932,25656,108.871219207983
SL050,34053535020,7608,3882,3726,104.186795491143
SL050,34053535021,18314,9102,9212,98.8059053408598
SL050,34053535022,71863,35916,35947,99.9137619272818
SL050,34053535023,13924,6928,6996,99.0280160091481
SL050,34053535024,22122,11179,10943,102.15662980901
SL050,34053535025,1921,1041,880,118.295454545455
SL050,34053535026,102424,50411,52013,96.9200007690385
SL050,34053535027,12449,6392,6057,105.530790820538
SL050,34053535028,20006,10259,9747,105.252898327691
SL050,34053535029,6119,3176,2943,107.91709140333
SL050,34053535030,14791,7559,7232,104.52157079646
SL050,34053535031,9278,4670,4608,101.345486111111
SL050,34053535032,3784,1974,1810,109.060773480663
SL050,34053535033,7625,3938,3687,106.807702739354
SL050,34053535034,16289,8436,7853,107.423914427607
SL050,34123636001,2637,1348,1289,104.577191621412
SL050,34123636002,3716,1846,1870,98.716577540107
SL050,34123636003,12134,5984,6150,97.3008130081301
SL050,34123636004,12148,5983,6165,97.0478507704785
SL050,34123636005,9860,4748,5112,92.8794992175274
SL050,34123636006,13814,6673,7141,93.4462960369696
SL050,34123636007,1806,848,958,88.517745302714
SL050,34123636008,26487,13078,13409,97.5315086881945
SL050,34123636009,5173,2527,2646,95.5026455026455
SL050,34123636010,3349,1623,1726,94.0324449594438
SL050,34123636013,2417,1224,1193,102.598491198659
SL050,34123636014,2032,981,1051,93.3396764985728
SL050,34123636015,4710,2243,2467,90.9201459262262
SL050,34123636016,1110,579,531,109.039548022599
SL050,34123636017,20661,9912,10749,92.2132291375942
SL050,34123636018,3451,1649,1802,91.5094339622642
SL050,34123636019,1640,783,857,91.365227537923
SL050,34123636020,2370,1182,1188,99.4949494949495
SL050,34123636021,14236,7074,7162,98.7712929349344
SL050,34123636022,10700,5289,5411,97.745333579745
SL050,34123636023,10013,4875,5138,94.8812767613857
SL050,34123636024,20103,9743,10360,94.0444015444015
SL050,34123636025,2430,1192,1238,96.2843295638126
SL050,34123636026,24362,12175,12187,99.901534421925
SL050,34123636027,5315,2595,2720,95.4044117647059
SL050,34123636028,4776,2279,2497,91.2695234281137
SL050,34123636029,19448,9435,10013,94.2275042444822
SL050,34123636030,4496,2232,2264,98.5865724381625
SL050,34123636031,618,317,301,105.31561461794
SL050,34123636032,4200,2025,2175,93.1034482758621
SL050,34123636033,15142,7490,7652,97.8829064296916
SL050,34123636034,3892,1881,2011,93.5355544505221
SL050,34123636035,17723,8701,9022,96.4420305918865
SL050,34123636036,3018,1513,1505,100.531561461794
SL050,34123636037,2980,1461,1519,96.181698485846
SL050,34123636038,82802,39189,43613,89.8562355261046
SL050,34123636039,19740,9735,10005,97.3013493253373
SL050,34123636040,2984,1431,1553,92.1442369607212
SL050,34123636041,17018,8441,8577,98.4143639967355
SL050,34123636042,22854,11091,11763,94.2871716398878
SL050,34123636043,5491,2642,2849,92.7342927342927
SL050,34123636044,3037,1505,1532,98.2375979112272
SL050,34123636045,29194,14219,14975,94.9515859766277
SL050,34123636046,5069,2478,2591,95.6387495175608
SL050,34123636047,2509,1274,1235,103.157894736842
SL050,34123636048,6249,3070,3179,96.5712488203838
SL050,34123636049,9146,4557,4589,99.3026803225104
SL050,34123636050,9691,4846,4845,100.020639834881
SL050,34123636051,17212,8487,8725,97.2722063037249
SL050,34123636052,8698,4237,4461,94.9787043263842
SL050,34123636053,7305,3622,3683,98.3437415150692
SL050,34123636054,13464,6782,6682,101.496557916791
SL050,34123636055,16902,8164,8738,93.4309910734722
SL050,34123636056,5927,2914,3013,96.714238300697
SL050,34123636057,293642,138980,154662,89.860469927972
SL050,34123636058,5954,2899,3055,94.8936170212766
SL050,34123636059,5273,2589,2684,96.4605067064084
SL050,34123636060,37519,17970,19549,91.9228605043736
SL050,34123636061,10352,5035,5317,94.6962572879443
SL050,34123636901,4958,2459,2499,98.3993597438976
SL050,34123636902,5815,2795,3020,92.5496688741722
SL050,34073737001,193,102,91,112.087912087912
SL050,34073737002,146,75,71,105.633802816901
SL050,34073737003,120,65,55,118.181818181818
SL050,34073737004,34,19,15,126.666666666667
SL050,34073737005,76,39,37,105.405405405405
SL050,34073737006,138,69,69,100
SL050,34073737007,463,241,222,108.558558558559
SL050,34073737008,5166,2591,2575,100.621359223301
SL050,34073737009,220,119,101,117.821782178218
SL050,34073737010,1107,547,560,97.6785714285714
SL050,34073737011,116,58,58,100
SL050,34073737012,155,83,72,115.277777777778
SL050,34073737013,116,61,55,110.909090909091
SL050,34073737014,1239,624,615,101.463414634146
SL050,34073737015,266,141,125,112.8
SL050,34073737016,696,349,347,100.576368876081
SL050,34073737017,256,136,120,113.333333333333
SL050,34073737018,113,65,48,135.416666666667
SL050,34073737019,141,78,63,123.809523809524
SL050,34073737020,486,263,223,117.937219730942
SL050,34073737021,74,35,39,89.7435897435897
SL050,34073737022,269,138,131,105.343511450382
SL050,34073737023,1989,995,994,100.10060362173
SL050,34073737024,102,53,49,108.163265306122
SL050,34073737025,290,155,135,114.814814814815
SL050,34073737026,195,104,91,114.285714285714
SL050,34073737027,254,143,111,128.828828828829
SL050,34073737028,157,92,65,141.538461538462
SL050,34073737029,215,122,93,131.182795698925
SL050,34073737030,93,50,43,116.279069767442
SL050,34073737031,372,208,164,126.829268292683
SL050,34073737032,644,346,298,116.107382550336
SL050,34073737033,102,55,47,117.021276595745
SL050,34073737034,86,42,44,95.4545454545455
SL050,34073737035,200,114,86,132.558139534884
SL050,34073737036,56,32,24,133.333333333333
SL050,34073737037,113,64,49,130.612244897959
SL050,34073737038,911,469,442,106.108597285068
SL050,34073737039,309,158,151,104.635761589404
SL050,34073737040,410,217,193,112.435233160622
SL050,34073737041,75,42,33,127.272727272727
SL050,34073737042,46,30,16,187.5
SL050,34073737044,442,238,204,116.666666666667
SL050,34073737045,26,14,12,116.666666666667
SL050,34073737046,12961,6133,6828,89.821323960164
SL050,34073737047,223,121,102,118.627450980392
SL050,34073737049,132,66,66,100
SL050,34073737050,69,40,29,137.931034482759
SL050,34073737051,85,48,37,129.72972972973
SL050,34073737052,315,155,160,96.875
SL050,34073737054,286,150,136,110.294117647059
SL050,34073737055,137,74,63,117.460317460317
SL050,34073737056,53,24,29,82.7586206896552
SL050,34073737057,231,127,104,122.115384615385
SL050,34073737058,56,29,27,107.407407407407
SL050,34073737059,132,69,63,109.52380952381
SL050,34073737060,351,189,162,116.666666666667
SL050,34073737061,232,117,115,101.739130434783
SL050,34073737062,77,45,32,140.625
SL050,34073737063,67,41,26,157.692307692308
SL050,34073737065,291,157,134,117.164179104478
SL050,34073737067,4256,2129,2127,100.094029149036
SL050,34073737068,383,195,188,103.723404255319
SL050,34073737069,1152,610,542,112.546125461255
SL050,34073737070,600,324,276,117.391304347826
SL050,34073737071,86,46,40,115
SL050,34073737072,161,84,77,109.090909090909
SL050,34073737073,676,340,336,101.190476190476
SL050,34073737074,164,96,68,141.176470588235
SL050,34073737077,266,153,113,135.398230088496
SL050,34073737078,906,458,448,102.232142857143
SL050,34073737079,77,54,23,234.782608695652
SL050,34073737080,260,139,121,114.876033057851
SL050,34073737081,986,518,468,110.683760683761
SL050,34073737082,878,482,396,121.717171717172
SL050,34073737083,195,108,87,124.137931034483
SL050,34073737085,6947,3456,3491,98.9974219421369
SL050,34073737086,100,57,43,132.558139534884
SL050,34073737087,1188,622,566,109.893992932862
SL050,34073737088,217,117,100,117
SL050,34073737089,68,37,31,119.354838709677
SL050,34073737090,61,28,33,84.8484848484848
SL050,34073737091,191,94,97,96.9072164948454
SL050,34073737092,2615,1339,1276,104.937304075235
SL050,34073737096,216,127,89,142.696629213483
SL050,34073737097,42,27,15,180
SL050,34073737098,331,166,165,100.606060606061
SL050,34073737099,66,34,32,106.25
SL050,34073737100,76,41,35,117.142857142857
SL050,34073737101,154,86,68,126.470588235294
SL050,34073737102,409,204,205,99.5121951219512
SL050,34073737103,490,262,228,114.912280701754
SL050,34073737104,25,12,13,92.3076923076923
SL050,34073737106,279,146,133,109.774436090226
SL050,34073737107,12513,6031,6482,93.042270904042
SL050,34073737108,108,50,58,86.2068965517241
SL050,34073737109,182,103,79,130.379746835443
SL050,34073737110,123,63,60,105
SL050,34073737112,155,89,66,134.848484848485
SL050,34073737113,450,242,208,116.346153846154
SL050,34073737114,78,42,36,116.666666666667
SL050,34073737115,127,69,58,118.965517241379
SL050,34073737116,73,39,34,114.705882352941
SL050,34073737117,2050,1072,978,109.61145194274
SL050,34073737118,126,72,54,133.333333333333
SL050,34073737119,103,61,42,145.238095238095
SL050,34073737120,110,53,57,92.9824561403509
SL050,34073737121,635,337,298,113.087248322148
SL050,34073737122,233,118,115,102.608695652174
SL050,34073737123,170,92,78,117.948717948718
SL050,34073737124,225,122,103,118.446601941748
SL050,34073737125,235,136,99,137.373737373737
SL050,34073737126,34,20,14,142.857142857143
SL050,34073737127,231,118,113,104.424778761062
SL050,34073737128,279,152,127,119.685039370079
SL050,34073737129,272,147,125,117.6
SL050,34073737130,193,106,87,121.83908045977
SL050,34073737131,191,105,86,122.093023255814
SL050,34073737132,362,182,180,101.111111111111
SL050,34073737133,109,64,45,142.222222222222
SL050,34073737134,217,120,97,123.711340206186
SL050,34073737135,1336,668,668,100
SL050,34073737136,680,336,344,97.6744186046512
SL050,34073737137,108,54,54,100
SL050,34073737138,248,127,121,104.95867768595
SL050,34073737139,232,116,116,100
SL050,34073737140,1188,626,562,111.387900355872
SL050,34073737141,160,74,86,86.046511627907
SL050,34073737142,690,396,294,134.69387755102
SL050,34073737143,429,210,219,95.8904109589041
SL050,34073737144,385,208,177,117.514124293785
SL050,34073737145,280,140,140,100
SL050,34073737146,115,65,50,130
SL050,34073737147,187,108,79,136.708860759494
SL050,34073737148,464,245,219,111.872146118721
SL050,34073737149,64,37,27,137.037037037037
SL050,34073737150,38,22,16,137.5
SL050,34073737151,154,79,75,105.333333333333
SL050,34073737152,444,238,206,115.533980582524
SL050,34073737154,145,85,60,141.666666666667
SL050,34073737155,68,41,27,151.851851851852
SL050,34073737156,5660,2825,2835,99.647266313933
SL050,34073737157,78,47,31,151.612903225806
SL050,34073737158,264,149,115,129.565217391304
SL050,34073737159,83,40,43,93.0232558139535
SL050,34073737160,669,337,332,101.506024096386
SL050,34073737161,140,75,65,115.384615384615
SL050,34073737162,222,116,106,109.433962264151
SL050,34073737163,37,21,16,131.25
SL050,34073737164,299,167,132,126.515151515152
SL050,34073737165,34,15,19,78.9473684210526
SL050,34073737166,224,116,108,107.407407407407
SL050,34073737167,191,100,91,109.89010989011
SL050,34073737168,486,262,224,116.964285714286
SL050,34073737169,192,110,82,134.146341463415
SL050,34073737170,1636,826,810,101.975308641975
SL050,34073737171,478,241,237,101.68776371308
SL050,34073737172,963,526,437,120.366132723112
SL050,34073737173,1619,819,800,102.375
SL050,34073737174,1085,563,522,107.854406130268
SL050,34073737175,459,237,222,106.756756756757
SL050,34073737176,140,77,63,122.222222222222
SL050,34073737177,266,149,117,127.350427350427
SL050,34073737178,100,56,44,127.272727272727
SL050,34073737179,212,112,100,112
SL050,34073737180,72,39,33,118.181818181818
SL050,34073737181,285,153,132,115.909090909091
SL050,34073737182,84,50,34,147.058823529412
SL050,34073737183,421,218,203,107.389162561576
SL050,34073737184,289,145,144,100.694444444444
SL050,34073737185,633,343,290,118.275862068966
SL050,34073737186,103,57,46,123.913043478261
SL050,34073737187,627,314,313,100.319488817891
SL050,34073737188,176,106,70,151.428571428571
SL050,34073737189,114,68,46,147.826086956522
SL050,34073737190,208,103,105,98.0952380952381
SL050,34073737191,115,68,47,144.68085106383
SL050,34073737192,426,224,202,110.891089108911
SL050,34073737193,399,214,185,115.675675675676
SL050,34073737194,275,142,133,106.766917293233
SL050,34073737195,44,26,18,144.444444444444
SL050,34073737196,70,38,32,118.75
SL050,34073737197,91,52,39,133.333333333333
SL050,34073737198,226,106,120,88.3333333333333
SL050,34073737199,142,75,67,111.940298507463
SL050,34073737200,221,125,96,130.208333333333
SL050,34073737201,266,142,124,114.516129032258
SL050,34073737202,1323,696,627,111.004784688995
SL050,34073737203,158,90,68,132.352941176471
SL050,34073737204,263,143,120,119.166666666667
SL050,34073737205,230,125,105,119.047619047619
SL050,34073737206,100,55,45,122.222222222222
SL050,34073737207,384,213,171,124.561403508772
SL050,34073737208,74,46,28,164.285714285714
SL050,34073737209,493,262,231,113.419913419913
SL050,34073737211,231,129,102,126.470588235294
SL050,34073737212,98,53,45,117.777777777778
SL050,34073737213,98,55,43,127.906976744186
SL050,34073737214,131,72,59,122.033898305085
SL050,34073737215,158,91,67,135.820895522388
SL050,34073737216,332,182,150,121.333333333333
SL050,34073737217,60,27,33,81.8181818181818
SL050,34073737218,56,37,19,194.736842105263
SL050,34073737219,177,90,87,103.448275862069
SL050,34073737221,460,240,220,109.090909090909
SL050,34073737222,90,52,38,136.842105263158
SL050,34073737223,100,53,47,112.765957446809
SL050,34073737224,207,108,99,109.090909090909
SL050,34073737225,113,60,53,113.207547169811
SL050,34073737226,161,78,83,93.9759036144578
SL050,34073737228,354,189,165,114.545454545455
SL050,34073737229,157,90,67,134.328358208955
SL050,34073737230,249,127,122,104.098360655738
SL050,34073737231,259,138,121,114.04958677686
SL050,34073737232,406,239,167,143.11377245509
SL050,34073737233,56,33,23,143.478260869565
SL050,34073737234,335,164,171,95.906432748538
SL050,34073737235,238,125,113,110.619469026549
SL050,34073737236,142,82,60,136.666666666667
SL050,34073737237,360,201,159,126.415094339623
SL050,34073737238,126,66,60,110
SL050,34073737239,216,111,105,105.714285714286
SL050,34073737240,1232,660,572,115.384615384615
SL050,34073737241,172,103,69,149.275362318841
SL050,34073737242,85,51,34,150
SL050,34073737243,100,48,52,92.3076923076923
SL050,34073737244,146,70,76,92.1052631578947
SL050,34073737245,364,182,182,100
SL050,34073737246,6308,3096,3212,96.3885429638854
SL050,34073737247,182,98,84,116.666666666667
SL050,34073737248,157,83,74,112.162162162162
SL050,34073737249,39,25,14,178.571428571429
SL050,34073737250,341,181,160,113.125
SL050,34073737251,122,58,64,90.625
SL050,34073737252,113,64,49,130.612244897959
SL050,34073737253,159,84,75,112
SL050,34073737254,188,105,83,126.506024096386
SL050,34073737255,47,30,17,176.470588235294
SL050,34073737256,223,127,96,132.291666666667
SL050,34073737257,46,25,21,119.047619047619
SL050,34073737258,177,94,83,113.253012048193
SL050,34073737259,38,23,15,153.333333333333
SL050,34073737260,149,77,72,106.944444444444
SL050,34073737261,227,127,100,127
SL050,34073737262,79,44,35,125.714285714286
SL050,34073737263,370,181,189,95.7671957671958
SL050,34073737264,59,29,30,96.6666666666667
SL050,34073737265,223,117,106,110.377358490566
SL050,34073737266,79,46,33,139.393939393939
SL050,34073737267,198,110,88,125
SL050,34073737268,117,66,51,129.411764705882
SL050,34073737269,499,268,231,116.017316017316
SL050,34073737270,196,100,96,104.166666666667
SL050,34073737271,376,207,169,122.485207100592
SL050,34073737272,147,81,66,122.727272727273
SL050,34073737273,99,56,43,130.232558139535
SL050,34073737274,143978,65278,78700,82.9453621346887
SL050,34073737275,109,60,49,122.448979591837
SL050,34073737276,137,83,54,153.703703703704
SL050,34073737277,75,36,39,92.3076923076923
SL050,34073737278,1015,538,477,112.788259958071
SL050,34073737279,826,448,378,118.518518518519
SL050,34073737280,84,44,40,110
SL050,34073737281,39,23,16,143.75
SL050,34073737282,222,119,103,115.533980582524
SL050,34073737283,125,76,49,155.102040816327
SL050,34073737284,347,195,152,128.289473684211
SL050,34073737285,413,214,199,107.537688442211
SL050,34073737286,219,118,101,116.831683168317
SL050,34073737287,347,180,167,107.784431137725
SL050,34073737288,337,187,150,124.666666666667
SL050,34073737289,239,122,117,104.273504273504
SL050,34073737290,145,80,65,123.076923076923
SL050,34073737291,301,166,135,122.962962962963
SL050,34073737292,89,49,40,122.5
SL050,34073737293,114,59,55,107.272727272727
SL050,34073737294,14732,7249,7483,96.8729119337164
SL050,34073737296,324,170,154,110.38961038961
SL050,34073737297,467,234,233,100.429184549356
SL050,34073737298,186,102,84,121.428571428571
SL050,34073737299,244,129,115,112.173913043478
SL050,34073737300,614,315,299,105.351170568562
SL050,34073737301,91,52,39,133.333333333333
SL050,34073737302,283,145,138,105.072463768116
SL050,34073737303,193,106,87,121.83908045977
SL050,34073737304,178,101,77,131.168831168831
SL050,34073737305,239,116,123,94.3089430894309
SL050,34073737306,270,146,124,117.741935483871
SL050,34073737307,154,80,74,108.108108108108
SL050,34073737309,44,20,24,83.3333333333333
SL050,34073737310,187,91,96,94.7916666666667
SL050,34073737311,232,117,115,101.739130434783
SL050,34073737312,273,142,131,108.396946564886
SL050,34073737313,580,307,273,112.454212454212
SL050,34073737314,107,62,45,137.777777777778
SL050,34073737315,88,49,39,125.641025641026
SL050,34073737316,804,408,396,103.030303030303
SL050,34073737317,317,170,147,115.646258503401
SL050,34073737318,212,123,89,138.202247191011
SL050,34073737319,104,56,48,116.666666666667
SL050,34073737320,90,50,40,125
SL050,34073737321,151,74,77,96.1038961038961
SL050,34073737322,3051,1537,1514,101.519154557464
SL050,34073737323,530,287,243,118.106995884774
SL050,34073737324,362,196,166,118.072289156627
SL050,34073737325,98,55,43,127.906976744186
SL050,34073737327,191,96,95,101.052631578947
SL050,34073737328,200,98,102,96.078431372549
SL050,34073737329,43,23,20,115
SL050,34073737330,351,179,172,104.06976744186
SL050,34073737331,203,115,88,130.681818181818
SL050,34073737332,79,43,36,119.444444444444
SL050,34073737333,214,127,87,145.977011494253
SL050,34073737334,73,37,36,102.777777777778
SL050,34073737335,407,199,208,95.6730769230769
SL050,34073737336,65,41,24,170.833333333333
SL050,34073737337,152,74,78,94.8717948717949
SL050,34073737338,100,50,50,100
SL050,34073737339,330,184,146,126.027397260274
SL050,34073737340,149,83,66,125.757575757576
SL050,34073737341,74,43,31,138.709677419355
SL050,34073737342,288,150,138,108.695652173913
SL050,34073737343,76,35,41,85.3658536585366
SL050,34073737344,264,133,131,101.526717557252
SL050,34073737345,168,91,77,118.181818181818
SL050,34073737346,285,134,151,88.7417218543046
SL050,34073737347,554,302,252,119.84126984127
SL050,34073737348,112,65,47,138.297872340426
SL050,34073737349,116,56,60,93.3333333333333
SL050,34073737350,422,210,212,99.0566037735849
SL050,34073737351,282,145,137,105.839416058394
SL050,34073737352,206,120,86,139.53488372093
SL050,34073737353,133,75,58,129.310344827586
SL050,34073737354,7207,3605,3602,100.083287062743
SL050,34073737355,159,80,79,101.26582278481
SL050,34073737356,95,49,46,106.521739130435
SL050,34073737357,279,142,137,103.649635036496
SL050,34073737358,201,127,74,171.621621621622
SL050,34073737359,179,94,85,110.588235294118
SL050,34073737360,229,115,114,100.877192982456
SL050,34073737361,89,50,39,128.205128205128
SL050,34073737362,6316,3134,3182,98.4915147705845
SL050,34073737363,123,59,64,92.1875
SL050,34073737364,805,417,388,107.474226804124
SL050,34073737365,197,111,86,129.06976744186
SL050,34073737366,43,28,15,186.666666666667
SL050,34073737367,191,106,85,124.705882352941
SL050,34073737368,23,8,15,53.3333333333333
SL050,34073737369,135,79,56,141.071428571429
SL050,34073737370,324,186,138,134.782608695652
SL050,34073737371,283,155,128,121.09375
SL050,34073737372,145,82,63,130.15873015873
SL050,34073737373,785,410,375,109.333333333333
SL050,34073737374,1358,687,671,102.384500745156
SL050,34073737375,780,392,388,101.030927835052
SL050,34073737376,2538,1237,1301,95.0807071483474
SL050,34073737377,244,129,115,112.173913043478
SL050,34073737378,98,57,41,139.024390243902
SL050,34073737379,206,126,80,157.5
SL050,34073737380,59,33,26,126.923076923077
SL050,34073737381,148,83,65,127.692307692308
SL050,34073737382,160,83,77,107.792207792208
SL050,34053838001,47280,23844,23436,101.740911418331
SL050,34053838002,1067,545,522,104.406130268199
SL050,34053838003,2006,1060,946,112.050739957717
SL050,34053838004,5562,2733,2829,96.6065747613998
SL050,34053838005,7831,4092,3739,109.44102701257
SL050,34053838006,79448,40638,38810,104.71012625612
SL050,34053838007,1855,941,914,102.954048140044
SL050,34053838008,7154,3499,3655,95.7318741450068
SL050,34053838009,5498,2790,2708,103.028064992614
SL050,34053838010,4755,2405,2350,102.340425531915
SL050,34053838011,27641,13426,14215,94.44952514949
SL050,34053838012,2768,1444,1324,109.063444108761
SL050,34053838013,4018,2022,1996,101.302605210421
SL050,34053838014,1709,872,837,104.181600955795
SL050,34053838015,4819,2411,2408,100.124584717608
SL050,34053838016,1626,853,773,110.349288486417
SL050,34053838017,48374,24156,24218,99.7439920720125
SL050,34053838018,5428,2647,2781,95.1815893563466
SL050,34053838019,20991,10485,10506,99.8001142204455
SL050,34053838020,19739,9792,9947,98.4417412285111
SL050,34053838021,1805,927,878,105.580865603645
SL050,34053838022,22749,11198,11551,96.9439875335469
SL050,34053838023,155549,75361,80188,93.9803960692373
SL050,34053838024,20171,9769,10402,93.9146318015766
SL050,34053838025,8956,4507,4449,101.303663744662
SL050,34053838026,41833,20512,21321,96.2056188734112
SL050,34053838027,7543,3747,3796,98.709167544784
SL050,34053838028,30483,14902,15581,95.6421282331044
SL050,34053838029,2073,1055,1018,103.634577603143
SL050,34053838030,2493,1234,1259,98.0142970611597
SL050,34053838031,36405,17868,18537,96.3910017802233
SL050,34053838032,17352,8772,8580,102.237762237762
SL050,34053838033,4112,2065,2047,100.879335613092
SL050,34053838034,4799,2380,2419,98.3877635386523
SL050,34053838035,19672,9895,9777,101.206914186356
SL050,34053838036,8945,4481,4464,100.38082437276
SL050,34053838037,15674,7588,8086,93.8412070244868
SL050,34053838038,204856,97841,107015,91.4273699948605
SL050,34053838039,14445,7223,7222,100.013846579895
SL050,34053838040,10755,5347,5408,98.8720414201184
SL050,34053838041,8947,4407,4540,97.0704845814978
SL050,34053838042,4757,2374,2383,99.6223248006714
SL050,34053838043,23961,11908,12053,98.796980004978
SL050,34053838044,2670,1293,1377,93.8997821350763
SL050,34053838045,4600,2350,2250,104.444444444444
SL050,34053838046,11203,5531,5672,97.5141043723554
SL050,34053838047,2564,1298,1266,102.527646129542
SL050,34053838048,4955,2500,2455,101.83299389002
SL050,34053838049,4484,2256,2228,101.256732495512
SL050,34053838050,2829,1471,1358,108.321060382916
SL050,34053838051,9040,4540,4500,100.888888888889
SL050,34053838052,1645,851,794,107.178841309824
SL050,34053838053,4791,2408,2383,101.049097775913
SL050,34053838901,1825,963,862,111.716937354988
SL050,34063939001,2408,1233,1175,104.936170212766
SL050,34063939002,4219,2139,2080,102.836538461538
SL050,34063939003,279,149,130,114.615384615385
SL050,34063939004,1676,864,812,106.4039408867
SL050,34063939005,1723,885,838,105.608591885442
SL050,34063939006,2108,1074,1034,103.868471953578
SL050,34063939007,470,267,203,131.527093596059
SL050,34063939008,18108,8840,9268,95.3819594302978
SL050,34063939009,4186,2178,2008,108.466135458167
SL050,34063939010,680,343,337,101.780415430267
SL050,34063939011,1972,1005,967,103.929679420889
SL050,34063939012,8349,4021,4328,92.9066543438078
SL050,34063939013,592,338,254,133.070866141732
SL050,34063939014,999,546,453,120.529801324503
SL050,34063939015,946,535,411,130.170316301703
SL050,34063939016,30263,14811,15452,95.8516696867719
SL050,34063939017,668,360,308,116.883116883117
SL050,34063939018,5778,2901,2877,100.834202294056
SL050,34063939019,2809,1443,1366,105.636896046852
SL050,34063939020,31977,15843,16134,98.1963555224991
SL050,34063939021,539,274,265,103.396226415094
SL050,34063939022,1337,695,642,108.255451713396
SL050,34063939023,8453,4145,4308,96.2163416898793
SL050,34063939024,2156,1021,1135,89.9559471365639
SL050,34063939025,10910,5331,5579,95.5547589173687
SL050,34063939026,2041,1038,1003,103.489531405783
SL050,34063939027,3750,1925,1825,105.479452054795
SL050,34063939028,5090,2571,2519,102.064311234617
SL050,34063939029,771,399,372,107.258064516129
SL050,34063939030,2347,1204,1143,105.336832895888
SL050,34063939031,1541,773,768,100.651041666667
SL050,34063939032,1627,899,728,123.489010989011
SL050,34063939033,609,344,265,129.811320754717
SL050,34063939034,287,182,105,173.333333333333
SL050,34063939035,11148,5301,5847,90.6618778860954
SL050,34063939036,1194,613,581,105.507745266781
SL050,34063939037,2370,1169,1201,97.3355537052456
SL050,34063939038,1867,932,935,99.6791443850267
SL050,34063939039,601,329,272,120.955882352941
SL050,34063939040,5118,2550,2568,99.2990654205608
SL050,34063939041,2120,1086,1034,105.029013539652
SL050,34063939042,7520,3632,3888,93.4156378600823
SL050,34063939043,1982,995,987,100.81053698075
SL050,34063939044,4713,2380,2333,102.014573510502
SL050,34063939045,389,201,188,106.914893617021
SL050,34063939046,1544,774,770,100.519480519481
SL050,34063939047,2539,1268,1271,99.7639653815893
SL050,34063939048,2108,1068,1040,102.692307692308
SL050,34063939049,321,176,145,121.379310344828
SL050,34063939050,285,165,120,137.5
SL050,34063939051,68,43,25,172
SL050,34063939052,25223,12484,12739,97.9982730198603
SL050,34063939053,238,151,87,173.563218390805
SL050,34063939054,5845,2891,2954,97.8672985781991
SL050,34063939055,1350,653,697,93.687230989957
SL050,34063939056,2868,1460,1408,103.693181818182
SL050,34063939057,2881,1446,1435,100.766550522648
SL050,34063939058,952,493,459,107.407407407407
SL050,34063939059,9095,4266,4829,88.3412714847795
SL050,34063939060,8381,4124,4257,96.8757340850364
SL050,34063939061,4447,2243,2204,101.769509981851
SL050,34063939062,2257,1170,1087,107.635694572217
SL050,34063939063,1038,584,454,128.63436123348
SL050,34063939064,1609,767,842,91.0926365795724
SL050,34063939065,268,154,114,135.087719298246
SL050,34063939066,1026,552,474,116.455696202532
SL050,34063939067,872,473,399,118.546365914787
SL050,34063939068,732,373,359,103.899721448468
SL050,34063939069,2387,1198,1189,100.756938603869
SL050,34063939070,147,76,71,107.042253521127
SL050,34063939071,466,260,206,126.21359223301
SL050,34063939072,370,220,150,146.666666666667
SL050,34063939073,12964,6383,6581,96.9913387023249
SL050,34063939074,9060,4554,4506,101.065246338216
SL050,34063939075,172044,79371,92673,85.646304748956
SL050,34063939076,4172,2051,2121,96.6996699669967
SL050,34063939077,257,151,106,142.452830188679
SL050,34063939078,1623,845,778,108.611825192802
SL050,34063939079,11050,5388,5662,95.1607205934299
SL050,34063939080,4158,2062,2096,98.3778625954198
SL050,34063939081,512,267,245,108.979591836735
SL050,34063939082,1891,947,944,100.317796610169
SL050,34063939083,1193,662,531,124.670433145009
SL050,34063939084,1050,557,493,112.981744421907
SL050,34063939085,8716,4294,4422,97.105382180009
SL050,34063939086,400,233,167,139.520958083832
SL050,34063939087,51687,24341,27346,89.011189936371
SL050,34063939088,64,44,20,220
SL050,34063939089,140,98,42,233.333333333333
SL050,34063939090,925,473,452,104.646017699115
SL050,34063939091,2191,1137,1054,107.874762808349
SL050,34063939092,967,512,455,112.527472527473
SL050,34063939093,316,181,135,134.074074074074
SL050,34063939094,974,549,425,129.176470588235
SL050,34063939095,2772,1441,1331,108.264462809917
SL050,34063939096,745,389,356,109.269662921348
SL050,34063939097,775,406,369,110.027100271003
SL050,34063939098,1604,840,764,109.947643979058
SL050,34063939099,3912,1941,1971,98.4779299847793
SL050,34063939100,1029,532,497,107.042253521127
SL050,34063939101,286,155,131,118.320610687023
SL050,34063939102,2745,1464,1281,114.285714285714
SL050,34074040001,845,420,425,98.8235294117647
SL050,34074040002,44,23,21,109.52380952381
SL050,34074040003,139,78,61,127.868852459016
SL050,34074040004,587,287,300,95.6666666666667
SL050,34074040005,27,18,9,200
SL050,34074040006,22,13,9,144.444444444444
SL050,34074040007,76,48,28,171.428571428571
SL050,34074040008,56,30,26,115.384615384615
SL050,34074040009,48,34,14,242.857142857143
SL050,34074040010,123,64,59,108.474576271186
SL050,34074040012,301,159,142,111.971830985915
SL050,34074040013,57,33,24,137.5
SL050,34074040014,57,33,24,137.5
SL050,34074040015,25,14,11,127.272727272727
SL050,34074040016,55,28,27,103.703703703704
SL050,34074040017,131,60,71,84.5070422535211
SL050,34074040018,79,45,34,132.352941176471
SL050,34074040019,32,23,9,255.555555555556
SL050,34074040020,175,83,92,90.2173913043478
SL050,34074040021,21,12,9,133.333333333333
SL050,34074040022,229,131,98,133.673469387755
SL050,34074040024,1203,623,580,107.413793103448
SL050,34074040025,169,91,78,116.666666666667
SL050,34074040026,149,62,87,71.2643678160919
SL050,34074040028,111,60,51,117.647058823529
SL050,34074040029,25,13,12,108.333333333333
SL050,34074040030,494,271,223,121.52466367713
SL050,34074040031,760,406,354,114.689265536723
SL050,34074040032,716,369,347,106.340057636888
SL050,34074040033,86,48,38,126.315789473684
SL050,34074040034,85,47,38,123.684210526316
SL050,34074040035,186,100,86,116.279069767442
SL050,34074040036,671,345,326,105.828220858896
SL050,34074040037,30,16,14,114.285714285714
SL050,34074040039,258,137,121,113.223140495868
SL050,34074040040,3543,1759,1784,98.5986547085202
SL050,34074040041,1321,695,626,111.022364217252
SL050,34074040043,2529,1309,1220,107.295081967213
SL050,34074040044,147,78,69,113.04347826087
SL050,34074040045,157,85,72,118.055555555556
SL050,34074040046,130,72,58,124.137931034483
SL050,34074040047,29,19,10,190
SL050,34074040048,36,19,17,111.764705882353
SL050,34074040049,50,28,22,127.272727272727
SL050,34074040051,45,26,19,136.842105263158
SL050,34074040052,95,51,44,115.909090909091
SL050,34074040053,117,62,55,112.727272727273
SL050,34074040054,138,78,60,130
SL050,34074040055,35,22,13,169.230769230769
SL050,34074040056,34,17,17,100
SL050,34074040057,1774,892,882,101.133786848073
SL050,34074040058,334,167,167,100
SL050,34074040059,123,60,63,95.2380952380952
SL050,34074040060,95,53,42,126.190476190476
SL050,34074040061,78,47,31,151.612903225806
SL050,34074040062,77,47,30,156.666666666667
SL050,34074040063,9584,4838,4746,101.938474504846
SL050,34074040065,754,380,374,101.604278074866
SL050,34074040068,27,17,10,170
SL050,34074040069,91,51,40,127.5
SL050,34074040070,178,106,72,147.222222222222
SL050,34074040071,43,22,21,104.761904761905
SL050,34074040072,273,148,125,118.4
SL050,34074040073,501,263,238,110.504201680672
SL050,34074040074,300,164,136,120.588235294118
SL050,34074040075,173,92,81,113.58024691358
SL050,34074040076,9061,4602,4459,103.206997084548
SL050,34074040077,1301,689,612,112.581699346405
SL050,34074040078,166,93,73,127.397260273973
SL050,34074040079,262,144,118,122.033898305085
SL050,34074040080,71,39,32,121.875
SL050,34074040081,116,62,54,114.814814814815
SL050,34074040082,119,65,54,120.37037037037
SL050,34074040083,172,78,94,82.9787234042553
SL050,34074040084,60,35,25,140
SL050,34074040086,852,449,403,111.414392059553
SL050,34074040087,96,53,43,123.255813953488
SL050,34074040088,343,176,167,105.389221556886
SL050,34074040089,241,128,113,113.274336283186
SL050,34074040091,103,57,46,123.913043478261
SL050,34074040092,142,82,60,136.666666666667
SL050,34074040093,94,52,42,123.809523809524
SL050,34074040094,450,233,217,107.373271889401
SL050,34074040095,688,362,326,111.042944785276
SL050,34074040097,223,127,96,132.291666666667
SL050,34074040099,58,34,24,141.666666666667
SL050,34074040100,308,169,139,121.58273381295
SL050,34074040101,1404,733,671,109.239940387481
SL050,34074040103,179,103,76,135.526315789474
SL050,34074040104,361,192,169,113.609467455621
SL050,34074040105,43,23,20,115
SL050,34074040106,208,103,105,98.0952380952381
SL050,34074040107,116,66,50,132
SL050,34074040108,111,65,46,141.304347826087
SL050,34074040109,82,50,32,156.25
SL050,34074040110,355,184,171,107.602339181287
SL050,34074040111,67,35,32,109.375
SL050,34074040112,3773,1911,1862,102.631578947368
SL050,34074040113,523,293,230,127.391304347826
SL050,34074040115,97,56,41,136.585365853659
SL050,34074040118,53,30,23,130.434782608696
SL050,34074040119,225,133,92,144.565217391304
SL050,34074040120,222,115,107,107.476635514019
SL050,34074040121,288,149,139,107.194244604317
SL050,34074040122,617,334,283,118.021201413428
SL050,34074040123,178,97,81,119.753086419753
SL050,34074040124,264,139,125,111.2
SL050,34074040125,89,53,36,147.222222222222
SL050,34074040126,77,40,37,108.108108108108
SL050,34074040127,29,16,13,123.076923076923
SL050,34074040128,137,75,62,120.967741935484
SL050,34074040129,185,100,85,117.647058823529
SL050,34074040130,148,88,60,146.666666666667
SL050,34074040131,61,35,26,134.615384615385
SL050,34074040132,54,31,23,134.782608695652
SL050,34074040134,904,488,416,117.307692307692
SL050,34074040135,306,166,140,118.571428571429
SL050,34074040136,154,75,79,94.9367088607595
SL050,34074040138,2790,1414,1376,102.761627906977
SL050,34074040139,291,156,135,115.555555555556
SL050,34074040140,106,56,50,112
SL050,34074040141,1062,553,509,108.644400785855
SL050,34074040142,53,27,26,103.846153846154
SL050,34074040143,91,55,36,152.777777777778
SL050,34074040144,25,16,9,177.777777777778
SL050,34074040145,1347,684,663,103.16742081448
SL050,34074040146,322,166,156,106.410256410256
SL050,34074040148,265,138,127,108.661417322835
SL050,34074040149,561,298,263,113.307984790875
SL050,34074040150,60,36,24,150
SL050,34074040151,54,29,25,116
SL050,34074040152,963,485,478,101.464435146444
SL050,34074040154,12,8,4,200
SL050,34074040155,5308,2738,2570,106.536964980545
SL050,34074040156,359,204,155,131.612903225806
SL050,34074040157,46,27,19,142.105263157895
SL050,34074040158,15,12,3,400
SL050,34074040159,188,109,79,137.974683544304
SL050,34074040160,100,55,45,122.222222222222
SL050,34074040161,49,32,17,188.235294117647
SL050,34074040162,520,275,245,112.244897959184
SL050,34074040163,46,24,22,109.090909090909
SL050,34074040164,202,103,99,104.040404040404
SL050,34074040165,84,45,39,115.384615384615
SL050,34074040166,305,160,145,110.344827586207
SL050,34074040168,28,18,10,180
SL050,34074040170,2099,1120,979,114.402451481103
SL050,34074040171,39,31,8,387.5
SL050,34074040172,38,25,13,192.307692307692
SL050,34074040173,185,99,86,115.116279069767
SL050,34074040174,372,196,176,111.363636363636
SL050,34074040176,463,249,214,116.355140186916
SL050,34074040177,148,81,67,120.89552238806
SL050,34074040178,104,57,47,121.276595744681
SL050,34074040179,930,450,480,93.75
SL050,34074040180,321,178,143,124.475524475524
SL050,34074040181,5267,2610,2657,98.2310876928867
SL050,34074040182,239,114,125,91.2
SL050,34074040183,135,68,67,101.492537313433
SL050,34074040184,297,158,139,113.669064748201
SL050,34074040185,999,547,452,121.017699115044
SL050,34074040186,39,20,19,105.263157894737
SL050,34074040188,94,62,32,193.75
SL050,34074040189,556,307,249,123.293172690763
SL050,34074040190,61,35,26,134.615384615385
SL050,34074040191,259,142,117,121.367521367521
SL050,34074040192,154,86,68,126.470588235294
SL050,34074040193,260,137,123,111.382113821138
SL050,34074040194,51683,24207,27476,88.1023438637356
SL050,34074040195,1065,550,515,106.796116504854
SL050,34074040196,34,23,11,209.090909090909
SL050,34074040198,25,14,11,127.272727272727
SL050,34074040199,113,60,53,113.207547169811
SL050,34074040200,51,24,27,88.8888888888889
SL050,34074040201,50,24,26,92.3076923076923
SL050,34074040202,57,25,32,78.125
SL050,34074040203,1323,691,632,109.335443037975
SL050,34074040204,194,108,86,125.581395348837
SL050,34074040205,260,139,121,114.876033057851
SL050,34074040206,187,96,91,105.494505494505
SL050,34074040207,1052,544,508,107.086614173228
SL050,34074040208,979,486,493,98.580121703854
SL050,34074040210,107,66,41,160.975609756098
SL050,34074040211,70,39,31,125.806451612903
SL050,34074040212,30,15,15,100
SL050,34074040213,91,49,42,116.666666666667
SL050,34074040214,241,136,105,129.52380952381
SL050,34074040215,80,46,34,135.294117647059
SL050,34074040216,1096,566,530,106.792452830189
SL050,34074040218,94,56,38,147.368421052632
SL050,34074040219,704,377,327,115.290519877676
SL050,34074040220,73,37,36,102.777777777778
SL050,34074040221,54,27,27,100
SL050,34074040222,230,127,103,123.300970873786
SL050,34074040223,260,156,104,150
SL050,34074040224,20,12,8,150
SL050,34074040225,1493,783,710,110.281690140845
SL050,34074040228,621,327,294,111.224489795918
SL050,34074040229,27,16,11,145.454545454545
SL050,34074040230,111,65,46,141.304347826087
SL050,34074040231,134,68,66,103.030303030303
SL050,34074040233,505,263,242,108.677685950413
SL050,34074040234,444,231,213,108.450704225352
SL050,34074040901,568,308,260,118.461538461538
SL050,34074040902,129,70,59,118.64406779661
SL050,34074040903,106,70,36,194.444444444444
SL050,34074040904,395,191,204,93.6274509803922
SL050,34074040905,135,75,60,125
SL050,34074040906,3021,1519,1502,101.131824234354
SL050,34014141001,2026,1006,1020,98.6274509803922
SL050,34014141002,1746,881,865,101.849710982659
SL050,34014141003,3193,1604,1589,100.943989930774
SL050,34014141004,75256,37383,37873,98.7062023077126
SL050,34014141005,11927,6072,5855,103.706233988044
SL050,34014141006,3387,1690,1697,99.5875073659399
SL050,34014141007,16301,8081,8220,98.30900243309
SL050,34014141008,1248,642,606,105.940594059406
SL050,34014141009,1379,716,663,107.993966817496
SL050,34014141010,6008,2999,3009,99.6676636756397
SL050,34014141011,19565,9682,9883,97.9662045937468
SL050,34014141012,4495,2257,2238,100.848972296693
SL050,34014141013,6092,3106,2986,104.018754186202
SL050,34014141014,3094,1594,1500,106.266666666667
SL050,34014141015,7177,3613,3564,101.374859708193
SL050,34014141016,10647,5336,5311,100.470721144794
SL050,34014141017,21964,10895,11069,98.4280422802421
SL050,34014141018,12608,6278,6330,99.1785150078989
SL050,34014141019,6618,3313,3305,100.242057488654
SL050,34014141020,16379,8193,8186,100.085511849499
SL050,34014141021,27463,13434,14029,95.7587853731556
SL050,34014141022,5281,2632,2649,99.358248395621
SL050,34014141023,10661,5443,5218,104.311996933691
SL050,34014141024,28620,14379,14241,100.96903307352
SL050,34014141025,2500,1221,1279,95.4652071931196
SL050,34014141026,5530,2821,2709,104.134366925065
SL050,34014141027,4810,2420,2390,101.255230125523
SL050,34014141028,2826,1455,1371,106.126914660832
SL050,34014141029,17350,8428,8922,94.4631248598969
SL050,34014141030,625,324,301,107.641196013289
SL050,34014141031,1439,741,698,106.160458452722
SL050,34014141032,4789,2360,2429,97.1593248250309
SL050,34014141033,5954,2943,3011,97.7416140817004
SL050,34014141034,30657,15304,15353,99.6808441346968
SL050,34014141035,1290,637,653,97.5497702909648
SL050,34014141036,4807,2415,2392,100.961538461538
SL050,34014141037,3958,2012,1946,103.391572456321
SL050,34014141038,133168,65541,67627,96.9154331849705
SL050,34014141039,39882,19662,20220,97.2403560830861
SL050,34014141040,15683,7865,7818,100.601176771553
SL050,34014141041,12503,6238,6265,99.5690343176377
SL050,34014141042,7139,3557,3582,99.3020658849805
SL050,34014141043,789,400,389,102.827763496144
SL050,34014141044,10054,5007,5047,99.2074499702794
SL050,34014141045,7541,3791,3750,101.093333333333
SL050,34014141046,3790,1902,1888,100.741525423729
SL050,34014141047,13471,6625,6846,96.7718375693836
SL050,34014141048,2646,1318,1328,99.2469879518072
SL050,34014141049,12650,6399,6251,102.367621180611
SL050,34014141050,6485,3214,3271,98.257413634974
SL050,34014141051,2944,1508,1436,105.013927576602
SL050,34014141052,3834,1969,1865,105.576407506702
SL050,34014141053,27432,13695,13737,99.6942563878576
SL050,34014141054,860,435,425,102.352941176471
SL050,34014141055,18861,9351,9510,98.3280757097792
SL050,34014141056,4572,2307,2265,101.854304635762
SL050,34014141057,282,141,141,100
SL050,34014141058,23473,11744,11729,100.127888140506
SL050,34014141059,45890,22348,23542,94.9282134058279
SL050,34014141060,19580,9781,9799,99.8163077865088
SL050,34014141061,2626,1340,1286,104.199066874028
SL050,34014141062,2720,1405,1315,106.844106463878
SL050,34014141063,3460,1759,1701,103.409758965315
SL050,34014141064,7081,3542,3539,100.084769708957
SL050,34014141065,27844,13728,14116,97.2513459903655
SL050,34014141066,1581,782,799,97.8723404255319
SL050,34014141067,9390,4710,4680,100.641025641026
SL050,34014141068,17622,8780,8842,99.2988011762045
SL050,34014141069,38246,19220,19026,101.019657311048
SL050,34014141070,8552,4311,4241,101.650554114596
SL050,34014141071,6924,3446,3478,99.0799309948246
SL050,34014141072,5205,2579,2626,98.2102056359482
SL050,34014141073,2037,1006,1031,97.5751697381183
SL050,34014141074,3669,1844,1825,101.041095890411
SL050,34014141075,13949,7021,6928,101.342378752887
SL050,34014141076,2658,1360,1298,104.776579352851
SL050,34014141077,11033,5492,5541,99.115683089695
SL050,34014141078,3013,1495,1518,98.4848484848485
SL050,34014141079,11879,5879,6000,97.9833333333333
SL050,34014141080,1507,746,761,98.0289093298292
SL050,34014141081,38406,19013,19393,98.0405300881761
SL050,34014141082,4243,2106,2137,98.5493682732803
SL050,34014141083,1360,684,676,101.183431952663
SL050,34014141084,3445,1701,1744,97.5344036697248
SL050,34014141085,5477,2655,2822,94.0822111977321
SL050,34014141086,21195,10194,11001,92.6643032451595
SL050,34014141087,13683,6774,6909,98.0460269214069
SL050,34014141088,599,310,289,107.266435986159
SL050,34014141089,8442,4189,4253,98.4951798730308
SL050,34014141090,4301,2131,2170,98.2027649769585
SL050,34014141091,688711,326935,361776,90.3694551324577
SL050,34014141092,9578,4755,4823,98.5900891561269
SL050,34014141093,25220,12451,12769,97.5095935468713
SL050,34014141094,8768,4406,4362,101.008711600183
SL050,34014141095,52617,26140,26477,98.727197190014
SL050,34014141096,7803,3828,3975,96.3018867924528
SL050,34014141097,4478,2214,2264,97.791519434629
SL050,34014141098,6571,3208,3363,95.3910199226881
SL050,34014141099,4860,2438,2422,100.660611065235
SL050,34014141100,1155,562,593,94.7723440134907
SL050,34014141101,7797,3943,3854,102.309289050337
SL050,34014141102,19191,9608,9583,100.260878639257
SL050,34014141901,3307,1632,1675,97.4328358208955
SL050,34014141902,5857,2923,2934,99.6250852079073
SL050,34014141903,8628,4346,4282,101.494628678188
SL050,34074242001,302,162,140,115.714285714286
SL050,34074242003,44,25,19,131.578947368421
SL050,34074242004,3008,1535,1473,104.209097080788
SL050,34074242006,189,119,70,170
SL050,34074242007,108,57,51,111.764705882353
SL050,34074242008,59,35,24,145.833333333333
SL050,34074242009,87,46,41,112.19512195122
SL050,34074242010,34,21,13,161.538461538462
SL050,34074242011,18,8,10,80
SL050,34074242012,30,16,14,114.285714285714
SL050,34074242013,36,21,15,140
SL050,34074242014,64,35,29,120.689655172414
SL050,34074242015,33,20,13,153.846153846154
SL050,34074242016,18,13,5,260
SL050,34074242017,183,96,87,110.344827586207
SL050,34074242018,139,78,61,127.868852459016
SL050,34074242019,572,336,236,142.372881355932
SL050,34074242020,5526,2807,2719,103.236484001471
SL050,34074242021,70,42,28,150
SL050,34074242022,236,138,98,140.816326530612
SL050,34074242023,63,38,25,152
SL050,34074242024,85,58,27,214.814814814815
SL050,34074242025,1489,789,700,112.714285714286
SL050,34074242026,24,12,12,100
SL050,34074242027,81,50,31,161.290322580645
SL050,34074242028,90,48,42,114.285714285714
SL050,34074242029,142,82,60,136.666666666667
SL050,34074242030,103,63,40,157.5
SL050,34074242031,23,16,7,228.571428571429
SL050,34074242032,147,82,65,126.153846153846
SL050,34074242033,51,31,20,155
SL050,34074242034,29,18,11,163.636363636364
SL050,34074242035,877,444,433,102.540415704388
SL050,34074242036,44,24,20,120
SL050,34074242037,35,19,16,118.75
SL050,34074242038,34,21,13,161.538461538462
SL050,34074242039,240,129,111,116.216216216216
SL050,34074242041,33,18,15,120
SL050,34074242042,59,32,27,118.518518518519
SL050,34074242043,4926,2452,2474,99.1107518189167
SL050,34074242044,56,34,22,154.545454545455
SL050,34074242045,357,203,154,131.818181818182
SL050,34074242046,51,28,23,121.739130434783
SL050,34074242048,57,38,19,200
SL050,34074242049,115,68,47,144.68085106383
SL050,34074242050,32,24,8,300
SL050,34074242051,16,8,8,100
SL050,34074242052,15,11,4,275
SL050,34074242053,23,15,8,187.5
SL050,34074242054,17,12,5,240
SL050,34074242055,169,87,82,106.09756097561
SL050,34074242056,27,19,8,237.5
SL050,34074242057,169,91,78,116.666666666667
SL050,34074242058,109,62,47,131.914893617021
SL050,34074242059,21,10,11,90.9090909090909
SL050,34074242060,30,20,10,200
SL050,34074242061,298,181,117,154.700854700855
SL050,34074242062,18,11,7,157.142857142857
SL050,34074242063,50,28,22,127.272727272727
SL050,34074242064,86,43,43,100
SL050,34074242065,22,16,6,266.666666666667
SL050,34074242068,79,49,30,163.333333333333
SL050,34074242069,1720,890,830,107.228915662651
SL050,34074242070,35,21,14,150
SL050,34074242071,198,109,89,122.47191011236
SL050,34074242073,72,45,27,166.666666666667
SL050,34074242075,83,47,36,130.555555555556
SL050,34074242076,216,114,102,111.764705882353
SL050,34074242078,1111,568,543,104.604051565378
SL050,34074242079,22,15,7,214.285714285714
SL050,34074242080,168,99,69,143.478260869565
SL050,34074242081,168,89,79,112.658227848101
SL050,34074242082,6,5,1,500
SL050,34074242083,24,13,11,118.181818181818
SL050,34074242084,18,13,5,260
SL050,34074242085,181,105,76,138.157894736842
SL050,34074242086,36,22,14,157.142857142857
SL050,34074242087,53,27,26,103.846153846154
SL050,34074242088,65,38,27,140.740740740741
SL050,34074242089,65,32,33,96.969696969697
SL050,34074242090,88,57,31,183.870967741935
SL050,34074242092,61,36,25,144
SL050,34074242093,40,27,13,207.692307692308
SL050,34074242094,736,398,338,117.751479289941
SL050,34074242095,2568,1349,1219,110.664479081214
SL050,34074242096,317,175,142,123.239436619718
SL050,34074242097,21,14,7,200
SL050,34074242098,9,7,2,350
SL050,34074242100,31,20,11,181.818181818182
SL050,34074242103,719,399,320,124.6875
SL050,34074242105,52,26,26,100
SL050,34074242106,14,10,4,250
SL050,34074242107,73,43,30,143.333333333333
SL050,34074242108,13,7,6,116.666666666667
SL050,34074242110,63,38,25,152
SL050,34074242111,301,156,145,107.586206896552
SL050,34074242113,721,358,363,98.6225895316804
SL050,34074242115,84,50,34,147.058823529412
SL050,34074242116,48,31,17,182.352941176471
SL050,34074242117,161,84,77,109.090909090909
SL050,34074242118,23,16,7,228.571428571429
SL050,34074242119,193,101,92,109.782608695652
SL050,34074242120,153,101,52,194.230769230769
SL050,34074242121,57,36,21,171.428571428571
SL050,34074242123,200,104,96,108.333333333333
SL050,34074242124,60,35,25,140
SL050,34074242125,86,56,30,186.666666666667
SL050,34074242127,31,20,11,181.818181818182
SL050,34074242128,49,27,22,122.727272727273
SL050,34074242129,776,413,363,113.774104683196
SL050,34074242130,53,36,17,211.764705882353
SL050,34074242131,56,30,26,115.384615384615
SL050,34074242132,150,80,70,114.285714285714
SL050,34074242134,3626,1879,1747,107.555809959931
SL050,34074242135,70,41,29,141.379310344828
SL050,34074242139,20,11,9,122.222222222222
SL050,34074242140,14,9,5,180
SL050,34074242141,106,68,38,178.947368421053
SL050,34074242142,57,27,30,90
SL050,34074242144,488,274,214,128.03738317757
SL050,34074242145,154,96,58,165.51724137931
SL050,34074242148,8,4,4,100
SL050,34074242149,477,267,210,127.142857142857
SL050,34074242151,38,17,21,80.9523809523809
SL050,34074242152,87,50,37,135.135135135135
SL050,34074242153,14,9,5,180
SL050,34074242154,106,65,41,158.536585365854
SL050,34074242155,163,96,67,143.283582089552
SL050,34074242156,30,20,10,200
SL050,34074242157,9,7,2,350
SL050,34074242158,126,74,52,142.307692307692
SL050,34074242159,39,26,13,200
SL050,34074242160,265,146,119,122.689075630252
SL050,34074242161,144,80,64,125
SL050,34074242162,3010,1580,1430,110.48951048951
SL050,34074242163,55,33,22,150
SL050,34074242164,2047,1037,1010,102.673267326733
SL050,34074242165,617,341,276,123.550724637681
SL050,34074242166,58,36,22,163.636363636364
SL050,34074242167,267,148,119,124.36974789916
SL050,34074242168,102,57,45,126.666666666667
SL050,34074242171,138,78,60,130
SL050,34074242172,32,17,15,113.333333333333
SL050,34074242173,39112,18426,20686,89.0747365367882
SL050,34074242174,180,96,84,114.285714285714
SL050,34074242175,25,15,10,150
SL050,34074242176,28,16,12,133.333333333333
SL050,34074242177,66,37,29,127.586206896552
SL050,34074242178,118,69,49,140.816326530612
SL050,34074242181,430,229,201,113.930348258706
SL050,34074242182,43,25,18,138.888888888889
SL050,34074242183,106,60,46,130.434782608696
SL050,34074242184,58,31,27,114.814814814815
SL050,34074242185,25,13,12,108.333333333333
SL050,34074242187,66,46,20,230
SL050,34074242188,52,22,30,73.3333333333333
SL050,34074242189,52,28,24,116.666666666667
SL050,34074242190,90,49,41,119.512195121951
SL050,34074242191,193,105,88,119.318181818182
SL050,34074242192,42,30,12,250
SL050,34074242193,20,11,9,122.222222222222
SL050,34074242194,159,70,89,78.6516853932584
SL050,34074242195,109,63,46,136.95652173913
SL050,34074242196,9,6,3,200
SL050,34074242197,71,40,31,129.032258064516
SL050,34074242198,25,15,10,150
SL050,34074242200,86,55,31,177.41935483871
SL050,34074242201,25,15,10,150
SL050,34074242202,21,11,10,110
SL050,34074242204,53,39,14,278.571428571429
SL050,34074242205,90,55,35,157.142857142857
SL050,34074242206,8,6,2,300
SL050,34074242207,50,26,24,108.333333333333
SL050,34074242208,22,15,7,214.285714285714
SL050,34074242209,145,90,55,163.636363636364
SL050,34074242211,87,51,36,141.666666666667
SL050,34074242212,70,46,24,191.666666666667
SL050,34074242213,34,19,15,126.666666666667
SL050,34074242215,874,468,406,115.270935960591
SL050,34074242216,27,19,8,237.5
SL050,34074242217,36,23,13,176.923076923077
SL050,34074242218,92,58,34,170.588235294118
SL050,34074242219,38,23,15,153.333333333333
SL050,34094343001,893,457,436,104.816513761468
SL050,34094343002,2371,1202,1169,102.822925577417
SL050,34094343003,464,238,226,105.309734513274
SL050,34094343004,9402,4754,4648,102.280550774527
SL050,34094343005,5108,2533,2575,98.368932038835
SL050,34094343006,838,420,418,100.478468899522
SL050,34094343007,864,442,422,104.739336492891
SL050,34094343008,368,195,173,112.71676300578
SL050,34094343009,1788,916,872,105.045871559633
SL050,34094343010,426,200,226,88.4955752212389
SL050,34094343011,1342,671,671,100
SL050,34094343012,5120,2491,2629,94.7508558387219
SL050,34094343013,6801,3398,3403,99.8530708198648
SL050,34094343014,20606,10351,10255,100.936128717699
SL050,34094343015,116,68,48,141.666666666667
SL050,34094343016,5505,2836,2669,106.257025103035
SL050,34094343017,129,74,55,134.545454545455
SL050,34094343018,466,232,234,99.1452991452991
SL050,34094343019,1674,871,803,108.468244084682
SL050,34094343020,3128,1583,1545,102.459546925566
SL050,34094343021,476,258,218,118.348623853211
SL050,34094343022,1898,944,954,98.9517819706499
SL050,34094343023,300,156,144,108.333333333333
SL050,34094343024,2190,1120,1070,104.672897196262
SL050,34094343025,714,342,372,91.9354838709677
SL050,34094343026,1142,620,522,118.773946360153
SL050,34094343027,219,119,100,119
SL050,34094343028,3464,1836,1628,112.776412776413
SL050,34094343029,379,198,181,109.39226519337
SL050,34094343030,687,350,337,103.857566765579
SL050,34094343031,2080,1060,1020,103.921568627451
SL050,34094343032,601,305,296,103.040540540541
SL050,34094343033,1070,554,516,107.364341085271
SL050,34094343034,673,333,340,97.9411764705882
SL050,34094343035,305,159,146,108.904109589041
SL050,34094343036,1141,597,544,109.742647058824
SL050,34094343037,25444,12767,12677,100.709947148379
SL050,34094343038,33362,16307,17055,95.6141893872765
SL050,34094343039,96,51,45,113.333333333333
SL050,34094343040,398,200,198,101.010101010101
SL050,34094343041,235,116,119,97.4789915966387
SL050,34094343042,2868,1438,1430,100.559440559441
SL050,34094343043,4344,2253,2091,107.747489239598
SL050,34094343044,5644,2840,2804,101.283880171184
SL050,34094343045,170,90,80,112.5
SL050,34094343046,103,54,49,110.204081632653
SL050,34094343047,6516,3411,3105,109.855072463768
SL050,34094343048,1023,531,492,107.926829268293
SL050,34094343049,964,510,454,112.334801762115
SL050,34094343050,3526,1788,1738,102.876869965478
SL050,34094343051,12326,6016,6310,95.3407290015848
SL050,34094343052,1170,570,600,95
SL050,34094343053,237,137,100,137
SL050,34094343054,3742,1810,1932,93.6853002070393
SL050,34094343055,2807,1405,1402,100.213980028531
SL050,34094343056,965,475,490,96.9387755102041
SL050,34094343057,42,27,15,180
SL050,34094343058,104,59,45,131.111111111111
SL050,34094343059,315,156,159,98.1132075471698
SL050,34094343060,3491,1751,1740,100.632183908046
SL050,34094343061,42,25,17,147.058823529412
SL050,34094343062,369,188,181,103.867403314917
SL050,34094343063,719,372,347,107.204610951009
SL050,34094343064,3009,1534,1475,104
SL050,34094343065,525,269,256,105.078125
SL050,34094343066,201,97,104,93.2692307692308
SL050,34094343067,762,403,359,112.256267409471
SL050,34094343068,591,291,300,97
SL050,34094343069,226,126,100,126
SL050,34094343070,270,125,145,86.2068965517241
SL050,34094343071,1146,598,548,109.124087591241
SL050,34094343072,118,62,56,110.714285714286
SL050,34094343073,100,56,44,127.272727272727
SL050,34094343074,2327,1146,1181,97.0364098221846
SL050,34094343075,94,57,37,154.054054054054
SL050,34094343076,599,320,279,114.695340501792
SL050,34094343077,577,285,292,97.6027397260274
SL050,34094343078,1066,544,522,104.214559386973
SL050,34094343079,498,275,223,123.318385650224
SL050,34094343080,276,150,126,119.047619047619
SL050,34094343081,799,410,389,105.398457583548
SL050,34094343082,498,275,223,123.318385650224
SL050,34094343083,183,90,93,96.7741935483871
SL050,34094343084,706,380,326,116.564417177914
SL050,34094343085,281,147,134,109.701492537313
SL050,34094343086,7384,3738,3646,102.523313219967
SL050,34094343088,2828,1456,1372,106.122448979592
SL050,34094343089,383,206,177,116.38418079096
SL050,34094343090,1437,764,673,113.521545319465
SL050,34094343091,167,98,69,142.028985507246
SL050,34094343092,11809,6140,5669,108.308343623214
SL050,34094343093,5642,2798,2844,98.3825597749648
SL050,34094343094,3071,1525,1546,98.6416558861578
SL050,34094343095,3649,1848,1801,102.609661299278
SL050,34094343096,157,87,70,124.285714285714
SL050,34094343097,570,282,288,97.9166666666667
SL050,34094343098,477,256,221,115.837104072398
SL050,34094343099,353,168,185,90.8108108108108
SL050,34094343100,4739,2384,2355,101.231422505308
SL050,34094343101,150,87,63,138.095238095238
SL050,34094343102,561,274,287,95.4703832752613
SL050,34094343103,1265,657,608,108.059210526316
SL050,34094343104,2863,1478,1385,106.714801444043
SL050,34094343105,210,115,95,121.052631578947
SL050,34094343106,998,501,497,100.804828973843
SL050,34094343107,503,268,235,114.042553191489
SL050,34094343108,2305,1195,1110,107.657657657658
SL050,34094343109,3893,1981,1912,103.608786610879
SL050,34094343110,328,180,148,121.621621621622
SL050,34094343111,2828,1485,1343,110.573343261355
SL050,34094343112,335,182,153,118.954248366013
SL050,34094343113,512,259,253,102.371541501976
SL050,34094343114,441,232,209,111.004784688995
SL050,34094343115,159,71,88,80.6818181818182
SL050,34094343116,589,307,282,108.86524822695
SL050,34094343117,179,96,83,115.66265060241
SL050,34094343118,709,374,335,111.641791044776
SL050,34094343119,1151,586,565,103.716814159292
SL050,34094343120,521,296,225,131.555555555556
SL050,34094343121,787,387,400,96.75
SL050,34094343122,153,80,73,109.58904109589
SL050,34094343123,103477,50030,53447,93.6067506127566
SL050,34094343124,576,318,258,123.255813953488
SL050,34094343125,1112,589,523,112.619502868069
SL050,34094343126,1701,845,856,98.714953271028
SL050,34094343127,1131,591,540,109.444444444444
SL050,34094343128,1186,622,564,110.283687943262
SL050,34094343129,6565,3375,3190,105.799373040752
SL050,34094343130,260,140,120,116.666666666667
SL050,34094343131,6461,3305,3156,104.721166032953
SL050,34094343132,480,258,222,116.216216216216
SL050,34094343133,7961,4111,3850,106.779220779221
SL050,34094343134,384,197,187,105.347593582888
SL050,34094343135,564,298,266,112.03007518797
SL050,34094343136,14611,7123,7488,95.1255341880342
SL050,34094343137,2551,1314,1237,106.224737267583
SL050,34094343138,3777,1916,1861,102.955400322407
SL050,34094343139,2697,1336,1361,98.1631153563556
SL050,34094343140,3328,1681,1647,102.064359441409
SL050,34094343141,114,63,51,123.529411764706
SL050,34094343142,1544,779,765,101.830065359477
SL050,34094343143,60,32,28,114.285714285714
SL050,34094343144,1697,846,851,99.4124559341951
SL050,34094343145,5632,2824,2808,100.569800569801
SL050,34094343146,47,32,15,213.333333333333
SL050,34094343147,619,318,301,105.647840531561
SL050,34094343148,132299,64282,68017,94.5087257597365
SL050,34094343149,882,451,431,104.640371229698
SL050,34094343150,1639,816,823,99.1494532199271
SL050,34094343151,137,71,66,107.575757575758
SL050,34094343152,628,325,303,107.260726072607
SL050,34094343153,15992,7821,8171,95.7165585607637
SL050,34094343154,148,82,66,124.242424242424
SL050,34094343155,33510,16607,16903,98.2488315683606
SL050,34094343156,6240,3209,3031,105.872649290663
SL050,34094343157,402,229,173,132.369942196532
SL050,34094343158,98,59,39,151.282051282051
SL050,34094343159,85,51,34,150
SL050,34094343160,1738,879,859,102.3282887078
SL050,34094343161,24156,12031,12125,99.2247422680412
SL050,34094343162,6386,3195,3191,100.125352554058
SL050,34094343163,37153,18452,18701,98.6685203999786
SL050,34094343164,410,229,181,126.519337016575
SL050,34094343165,746,386,360,107.222222222222
SL050,34094343166,2339,1185,1154,102.686308492201
SL050,34094343167,549,285,264,107.954545454545
SL050,34094343168,117,63,54,116.666666666667
SL050,34094343169,579,299,280,106.785714285714
SL050,34094343170,1253,655,598,109.531772575251
SL050,34094343171,22107,11083,11024,100.535195936139
SL050,34094343172,456,237,219,108.219178082192
SL050,34094343173,132,74,58,127.586206896552
SL050,34094343174,202,111,91,121.978021978022
SL050,34094343175,635,321,314,102.229299363057
SL050,34094343176,917,505,412,122.572815533981
SL050,34094343177,432,222,210,105.714285714286
SL050,34094343178,1974,1030,944,109.110169491525
SL050,34094343901,11505,5792,5713,101.382811132505
SL050,34094343902,3481,1734,1747,99.2558672009159
SL050,34094343903,3278,1666,1612,103.349875930521
SL050,34094343904,4137,2186,1951,112.045105074321
SL050,34094343905,26775,13856,12919,107.252883350105
SL050,34094343906,3280,1670,1610,103.726708074534
SL050,34094343907,5842,2858,2984,95.7774798927614
SL050,34024444001,76,48,28,171.428571428571
SL050,34024444002,49,31,18,172.222222222222
SL050,34024444003,18,6,12,50
SL050,34024444004,522,258,264,97.7272727272727
SL050,34024444005,63,36,27,133.333333333333
SL050,34024444006,264,134,130,103.076923076923
SL050,34024444007,178,98,80,122.5
SL050,34024444008,2004,1023,981,104.281345565749
SL050,34024444009,1016,517,499,103.607214428858
SL050,34024444010,257,137,120,114.166666666667
SL050,34024444011,63,38,25,152
SL050,34024444012,347,193,154,125.324675324675
SL050,34024444013,15939,7919,8020,98.7406483790524
SL050,34024444014,3276,1656,1620,102.222222222222
SL050,34024444016,531,281,250,112.4
SL050,34024444017,358,200,158,126.582278481013
SL050,34024444018,16,11,5,220
SL050,34024444019,62,37,25,148
SL050,34024444020,22,13,9,144.444444444444
SL050,34024444021,126,63,63,100
SL050,34024444022,582,295,287,102.787456445993
SL050,34024444023,29,16,13,123.076923076923
SL050,34024444024,27,17,10,170
SL050,34024444025,7633,3847,3786,101.611199154781
SL050,34024444026,105,61,44,138.636363636364
SL050,34024444027,206,103,103,100
SL050,34024444028,198,96,102,94.1176470588235
SL050,34024444029,708,355,353,100.56657223796
SL050,34024444031,94,46,48,95.8333333333333
SL050,34024444032,20,12,8,150
SL050,34024444033,311,172,139,123.741007194245
SL050,34024444034,153,86,67,128.358208955224
SL050,34024444035,118,64,54,118.518518518519
SL050,34024444036,31,18,13,138.461538461538
SL050,34024444037,541,273,268,101.865671641791
SL050,34024444038,113,54,59,91.5254237288136
SL050,34024444039,225,107,118,90.6779661016949
SL050,34024444040,244,125,119,105.042016806723
SL050,34024444041,70,44,26,169.230769230769
SL050,34024444042,125,74,51,145.098039215686
SL050,34024444043,95,62,33,187.878787878788
SL050,34024444044,106,57,49,116.326530612245
SL050,34024444045,443,252,191,131.937172774869
SL050,34024444046,63,34,29,117.241379310345
SL050,34024444047,243,130,113,115.044247787611
SL050,34024444048,55,31,24,129.166666666667
SL050,34024444049,1011,503,508,99.0157480314961
SL050,34024444050,4319,2138,2181,98.0284273269143
SL050,34024444051,3708,1842,1866,98.7138263665595
SL050,34024444052,74,45,29,155.172413793103
SL050,34024444053,124,69,55,125.454545454545
SL050,34024444054,113,71,42,169.047619047619
SL050,34024444055,86,52,34,152.941176470588
SL050,34024444056,619,321,298,107.718120805369
SL050,34024444059,714,373,341,109.384164222874
SL050,34024444060,39,25,14,178.571428571429
SL050,34024444061,87,53,34,155.882352941176
SL050,34024444062,35,25,10,250
SL050,34024444063,98,52,46,113.04347826087
SL050,34024444064,71,43,28,153.571428571429
SL050,34024444065,62,39,23,169.565217391304
SL050,34024444066,104,58,46,126.086956521739
SL050,34024444067,160,82,78,105.128205128205
SL050,34024444068,831,432,399,108.270676691729
SL050,34024444070,52,34,18,188.888888888889
SL050,34024444071,676,349,327,106.727828746177
SL050,34024444074,630,310,320,96.875
SL050,34024444075,396,227,169,134.319526627219
SL050,34024444076,2606,1351,1255,107.649402390438
SL050,34024444077,100,62,38,163.157894736842
SL050,34024444080,344,183,161,113.664596273292
SL050,34024444082,109,58,51,113.725490196078
SL050,34024444084,61,27,34,79.4117647058823
SL050,34024444085,52,31,21,147.619047619048
SL050,34024444086,571,289,282,102.482269503546
SL050,34024444087,68,33,35,94.2857142857143
SL050,34024444088,41,26,15,173.333333333333
SL050,34024444089,54,36,18,200
SL050,34024444090,80,46,34,135.294117647059
SL050,34024444092,86,47,39,120.512820512821
SL050,34024444093,122,69,53,130.188679245283
SL050,34024444094,131,70,61,114.754098360656
SL050,34024444096,180,91,89,102.247191011236
SL050,34024444097,139,68,71,95.7746478873239
SL050,34024444099,885,472,413,114.285714285714
SL050,34024444100,210,115,95,121.052631578947
SL050,34024444101,63,35,28,125
SL050,34024444102,28,16,12,133.333333333333
SL050,34024444103,151,86,65,132.307692307692
SL050,34024444105,75,39,36,108.333333333333
SL050,34024444106,205,113,92,122.826086956522
SL050,34024444107,238,130,108,120.37037037037
SL050,34024444108,443,247,196,126.020408163265
SL050,34024444109,116,67,49,136.734693877551
SL050,34024444110,42,24,18,133.333333333333
SL050,34024444111,101,58,43,134.883720930233
SL050,34024444112,461,249,212,117.452830188679
SL050,34024444113,114,60,54,111.111111111111
SL050,34024444114,286,145,141,102.836879432624
SL050,34024444115,161,83,78,106.410256410256
SL050,34024444116,89,48,41,117.073170731707
SL050,34024444117,376,200,176,113.636363636364
SL050,34024444118,200,108,92,117.391304347826
SL050,34024444119,143,85,58,146.551724137931
SL050,34024444120,242,138,104,132.692307692308
SL050,34024444121,72,39,33,118.181818181818
SL050,34024444122,1709,866,843,102.728351126928
SL050,34024444123,119,67,52,128.846153846154
SL050,34024444124,85,44,41,107.317073170732
SL050,34024444125,67,41,26,157.692307692308
SL050,34024444126,414,216,198,109.090909090909
SL050,34024444127,65,37,28,132.142857142857
SL050,34024444128,70,37,33,112.121212121212
SL050,34024444129,40,25,15,166.666666666667
SL050,34024444130,34,19,15,126.666666666667
SL050,34024444131,34,20,14,142.857142857143
SL050,34024444132,78,42,36,116.666666666667
SL050,34024444133,24,17,7,242.857142857143
SL050,34024444135,101,63,38,165.789473684211
SL050,34024444136,55,29,26,111.538461538462
SL050,34024444137,249,144,105,137.142857142857
SL050,34024444138,129,78,51,152.941176470588
SL050,34024444141,172,90,82,109.756097560976
SL050,34024444142,27,15,12,125
SL050,34024444143,519,274,245,111.836734693878
SL050,34024444144,417,210,207,101.449275362319
SL050,34024444145,1272,664,608,109.210526315789
SL050,34024444146,265,131,134,97.7611940298507
SL050,34024444147,539,285,254,112.204724409449
SL050,34024444148,98,58,40,145
SL050,34024444149,116,67,49,136.734693877551
SL050,34024444150,35,23,12,191.666666666667
SL050,34024444151,243,125,118,105.932203389831
SL050,34024444152,65,46,19,242.105263157895
SL050,34024444153,2433,1208,1225,98.6122448979592
SL050,34024444154,340,201,139,144.604316546763
SL050,34024444155,1243,623,620,100.483870967742
SL050,34024444156,50,27,23,117.391304347826
SL050,34024444157,63,35,28,125
SL050,34024444158,1541,769,772,99.6113989637306
SL050,34024444159,55,30,25,120
SL050,34024444160,551,300,251,119.521912350598
SL050,34024444161,599,311,288,107.986111111111
SL050,34024444163,133,72,61,118.032786885246
SL050,34024444164,25,16,9,177.777777777778
SL050,34024444165,217,123,94,130.851063829787
SL050,34024444167,45,24,21,114.285714285714
SL050,34024444168,205,108,97,111.340206185567
SL050,34024444169,377,206,171,120.46783625731
SL050,34024444171,226,129,97,132.989690721649
SL050,34024444172,364,190,174,109.195402298851
SL050,34024444173,122,67,55,121.818181818182
SL050,34024444174,487,267,220,121.363636363636
SL050,34024444175,126,68,58,117.241379310345
SL050,34024444176,169,99,70,141.428571428571
SL050,34024444177,110,64,46,139.130434782609
SL050,34024444178,53,30,23,130.434782608696
SL050,34024444179,439,242,197,122.842639593909
SL050,34024444180,76,42,34,123.529411764706
SL050,34024444181,88,49,39,125.641025641026
SL050,34024444182,221,118,103,114.563106796117
SL050,34024444183,79,42,37,113.513513513514
SL050,34024444184,43,28,15,186.666666666667
SL050,34024444185,114,73,41,178.048780487805
SL050,34024444187,243,121,122,99.1803278688525
SL050,34024444189,48,29,19,152.631578947368
SL050,34024444190,68,36,32,112.5
SL050,34024444191,908,456,452,100.884955752212
SL050,34024444192,453,253,200,126.5
SL050,34024444193,112,58,54,107.407407407407
SL050,34024444194,143,84,59,142.372881355932
SL050,34024444195,93,54,39,138.461538461538
SL050,34024444196,144,67,77,87.012987012987
SL050,34024444197,61,33,28,117.857142857143
SL050,34024444198,206,113,93,121.505376344086
SL050,34024444199,50,28,22,127.272727272727
SL050,34024444200,38,23,15,153.333333333333
SL050,34024444201,627,327,300,109
SL050,34024444203,17,11,6,183.333333333333
SL050,34024444204,26,17,9,188.888888888889
SL050,34024444205,783,395,388,101.80412371134
SL050,34024444206,125,79,46,171.739130434783
SL050,34024444207,148,78,70,111.428571428571
SL050,34024444208,37,18,19,94.7368421052632
SL050,34024444209,1037,528,509,103.732809430255
SL050,34024444210,1133,591,542,109.040590405904
SL050,34024444211,39,25,14,178.571428571429
SL050,34024444212,39,17,22,77.2727272727273
SL050,34024444213,80,45,35,128.571428571429
SL050,34024444215,183,103,80,128.75
SL050,34024444216,35691,16974,18717,90.6876101939413
SL050,34024444217,30,25,5,500
SL050,34024444218,31,19,12,158.333333333333
SL050,34024444219,213,112,101,110.891089108911
SL050,34024444220,156,86,70,122.857142857143
SL050,34024444221,423,218,205,106.341463414634
SL050,34024444222,127,83,44,188.636363636364
SL050,34024444223,89,43,46,93.4782608695652
SL050,34024444224,28,15,13,115.384615384615
SL050,34024444225,132,63,69,91.304347826087
SL050,34024444226,154,81,73,110.958904109589
SL050,34024444227,88,45,43,104.651162790698
SL050,34024444228,107,60,47,127.659574468085
SL050,34024444229,183,105,78,134.615384615385
SL050,34024444230,189,95,94,101.063829787234
SL050,34024444231,38,15,23,65.2173913043478
SL050,34024444232,447,237,210,112.857142857143
SL050,34024444234,64,39,25,156
SL050,34024444235,106,53,53,100
SL050,34024444236,65,32,33,96.969696969697
SL050,34024444237,436,217,219,99.0867579908676
SL050,34024444238,2970,1534,1436,106.824512534819
SL050,34024444239,21,11,10,110
SL050,34024444240,174,97,77,125.974025974026
SL050,34024444241,622,308,314,98.0891719745223
SL050,34024444243,35,21,14,150
SL050,34024444244,87,50,37,135.135135135135
SL050,34024444245,279,135,144,93.75
SL050,34024444246,2388,1207,1181,102.201524132091
SL050,34024444247,325,164,161,101.863354037267
SL050,34024444249,48,28,20,140
SL050,34024444250,20,12,8,150
SL050,34024444251,297,153,144,106.25
SL050,34024444252,94,60,34,176.470588235294
SL050,34024444256,47,27,20,135
SL050,34024444257,164,96,68,141.176470588235
SL050,34024444258,60,37,23,160.869565217391
SL050,34024444260,177,105,72,145.833333333333
SL050,34024444261,862,448,414,108.212560386473
SL050,34024444262,160,86,74,116.216216216216
SL050,34024444263,494,252,242,104.132231404959
SL050,34024444264,327,182,145,125.51724137931
SL050,34024444265,249,133,116,114.655172413793
SL050,34024444266,125,54,71,76.056338028169
SL050,34024444267,79,38,41,92.6829268292683
SL050,34024444268,16,5,11,45.4545454545455
SL050,34084545001,2244,1116,1128,98.936170212766
SL050,34084545002,3562,1874,1688,111.018957345972
SL050,34084545003,692,359,333,107.807807807808
SL050,34084545004,669,347,322,107.76397515528
SL050,34084545005,275,139,136,102.205882352941
SL050,34084545006,1703,843,860,98.0232558139535
SL050,34084545007,797,394,403,97.7667493796526
SL050,34084545008,162,87,75,116
SL050,34084545009,542,273,269,101.486988847584
SL050,34084545010,434,218,216,100.925925925926
SL050,34084545011,305,160,145,110.344827586207
SL050,34084545012,783,388,395,98.2278481012658
SL050,34084545013,2159,1133,1026,110.428849902534
SL050,34084545014,5032,2571,2461,104.469727752946
SL050,34084545015,829,411,418,98.3253588516746
SL050,34084545016,6341,3166,3175,99.7165354330709
SL050,34084545017,289,142,147,96.5986394557823
SL050,34084545018,856,445,411,108.272506082725
SL050,34084545019,10092,5061,5031,100.596302921884
SL050,34084545020,1529,763,766,99.6083550913838
SL050,34084545021,3706,1936,1770,109.378531073446
SL050,34084545022,430,220,210,104.761904761905
SL050,34084545023,3184,1641,1543,106.351263771873
SL050,34084545024,1308,672,636,105.660377358491
SL050,34084545025,1789,922,867,106.343713956171
SL050,34084545026,240,124,116,106.896551724138
SL050,34084545027,347,187,160,116.875
SL050,34084545028,4640,2351,2289,102.708606378331
SL050,34084545029,210,103,107,96.2616822429907
SL050,34084545030,539,300,239,125.523012552301
SL050,34084545031,3745,1950,1795,108.635097493036
SL050,34084545032,556,282,274,102.919708029197
SL050,34084545033,364,190,174,109.195402298851
SL050,34084545034,1740,893,847,105.43093270366
SL050,34084545035,342,183,159,115.094339622642
SL050,34084545036,731,373,358,104.189944134078
SL050,34084545037,1872,944,928,101.724137931034
SL050,34084545038,4761,2469,2292,107.722513089005
SL050,34084545039,271,136,135,100.740740740741
SL050,34084545040,1743,935,808,115.717821782178
SL050,34084545041,5422,2853,2569,111.054885169327
SL050,34084545042,208,103,105,98.0952380952381
SL050,34084545043,917,455,462,98.4848484848485
SL050,34084545045,1725,898,827,108.585247883918
SL050,34084545046,3263,1650,1613,102.293862368258
SL050,34084545047,3687,1915,1772,108.069977426637
SL050,34084545048,418,230,188,122.340425531915
SL050,34084545049,509,258,251,102.788844621514
SL050,34084545050,532,281,251,111.95219123506
SL050,34084545051,2206,1141,1065,107.136150234742
SL050,34084545052,4269,2150,2119,101.46295422369
SL050,34084545053,10098,5101,4997,102.08124874925
SL050,34084545054,5355,2755,2600,105.961538461538
SL050,34084545055,1335,693,642,107.943925233645
SL050,34084545056,3765,1969,1796,109.632516703786
SL050,34084545057,261,139,122,113.934426229508
SL050,34084545058,404,209,195,107.179487179487
SL050,34084545059,2201,1132,1069,105.893358278765
SL050,34084545060,207,107,100,107
SL050,34084545061,3199,1648,1551,106.254029658285
SL050,34084545062,1437,715,722,99.0304709141274
SL050,34084545063,439,244,195,125.128205128205
SL050,34084545064,5449,2744,2705,101.441774491682
SL050,34084545065,233,122,111,109.90990990991
SL050,34084545066,11032,5580,5452,102.347762289068
SL050,34084545067,3016,1508,1508,100
SL050,34084545068,187,98,89,110.112359550562
SL050,34084545069,2289,1158,1131,102.387267904509
SL050,34084545070,1781,897,884,101.470588235294
SL050,34084545071,2236,1127,1109,101.623083859333
SL050,34084545072,798,428,370,115.675675675676
SL050,34084545073,334,169,165,102.424242424242
SL050,34084545074,394,217,177,122.598870056497
SL050,34084545075,152,92,60,153.333333333333
SL050,34084545076,680,361,319,113.166144200627
SL050,34084545077,683,351,332,105.722891566265
SL050,34084545078,1681,827,854,96.8384074941452
SL050,34084545079,406,211,195,108.205128205128
SL050,34084545080,5,4,1,400
SL050,34084545081,28064,14238,13826,102.979892955302
SL050,34084545082,1405,699,706,99.0084985835694
SL050,34084545083,685,339,346,97.9768786127168
SL050,34084545084,2600,1353,1247,108.50040096231
SL050,34084545085,2345,1228,1117,109.93733213966
SL050,34084545086,573,304,269,113.011152416357
SL050,34084545087,10532,5281,5251,100.571319748619
SL050,34084545088,3401,1739,1662,104.632972322503
SL050,34084545089,1732,889,843,105.456702253855
SL050,34084545090,396,191,205,93.1707317073171
SL050,34084545091,461,227,234,97.008547008547
SL050,34084545092,255,125,130,96.1538461538462
SL050,34084545093,153,80,73,109.58904109589
SL050,34084545094,439,223,216,103.240740740741
SL050,34084545095,853,427,426,100.234741784038
SL050,34084545096,1258,647,611,105.891980360065
SL050,34084545097,1265,652,613,106.362153344209
SL050,34084545098,2702,1423,1279,111.258795934324
SL050,34084545099,4957,2545,2412,105.514096185738
SL050,34084545100,222,118,104,113.461538461538
SL050,34084545101,4908,2453,2455,99.918533604888
SL050,34084545102,4829,2436,2393,101.796907647305
SL050,34084545103,407,226,181,124.861878453039
SL050,34084545104,506,268,238,112.605042016807
SL050,34084545105,408,218,190,114.736842105263
SL050,34084545106,9737,4889,4848,100.845709570957
SL050,34084545107,4610,2361,2249,104.979991107159
SL050,34084545108,538,278,260,106.923076923077
SL050,34084545109,3647,1882,1765,106.628895184136
SL050,34084545110,2042,1080,962,112.266112266112
SL050,34084545111,62,32,30,106.666666666667
SL050,34084545112,2567,1351,1216,111.101973684211
SL050,34084545113,2171,1111,1060,104.811320754717
SL050,34084545114,626,315,311,101.286173633441
SL050,34084545115,3486,1771,1715,103.265306122449
SL050,34084545116,881,448,433,103.464203233256
SL050,34084545117,883,466,417,111.750599520384
SL050,34084545118,2767,1419,1348,105.26706231454
SL050,34084545119,4846,2534,2312,109.602076124567
SL050,34084545120,131,74,57,129.824561403509
SL050,34084545121,11067,5593,5474,102.173913043478
SL050,34084545122,7657,3936,3721,105.778016662188
SL050,34084545123,4279,2269,2010,112.885572139303
SL050,34084545124,2624,1311,1313,99.8476770753998
SL050,34084545125,2658,1308,1350,96.8888888888889
SL050,34084545126,338,177,161,109.937888198758
SL050,34084545127,907,487,420,115.952380952381
SL050,34084545128,3238,1629,1609,101.243008079553
SL050,34084545129,119,58,61,95.0819672131148
SL050,34084545130,343,184,159,115.723270440252
SL050,34084545131,305,174,131,132.824427480916
SL050,34084545132,2907,1502,1405,106.903914590747
SL050,34084545133,3788,1891,1897,99.6837111228255
SL050,34084545134,2188,1098,1090,100.733944954128
SL050,34084545135,5278,2676,2602,102.843966179862
SL050,34084545136,7811,3969,3842,103.305570015617
SL050,34084545137,2188,1103,1085,101.658986175115
SL050,34084545138,1246,620,626,99.0415335463259
SL050,34084545139,161,86,75,114.666666666667
SL050,34084545140,1521,776,745,104.161073825503
SL050,34084545141,1006,513,493,104.056795131846
SL050,34084545142,10918,5413,5505,98.3287920072661
SL050,34084545143,1511,773,738,104.742547425474
SL050,34084545144,945,509,436,116.743119266055
SL050,34084545145,4206,2311,1895,121.952506596306
SL050,34084545146,105,54,51,105.882352941176
SL050,34084545147,741,375,366,102.459016393443
SL050,34084545148,289,163,126,129.365079365079
SL050,34084545149,594,295,299,98.6622073578595
SL050,34084545150,438,235,203,115.76354679803
SL050,34084545151,726,360,366,98.3606557377049
SL050,34084545152,694,362,332,109.036144578313
SL050,34084545153,1805,907,898,101.002227171492
SL050,34084545154,1871,996,875,113.828571428571
SL050,34084545155,365,206,159,129.559748427673
SL050,34084545156,4238,2142,2096,102.19465648855
SL050,34084545157,2946,1546,1400,110.428571428571
SL050,34084545158,3217,1649,1568,105.165816326531
SL050,34084545159,100,60,40,150
SL050,34084545160,1353,678,675,100.444444444444
SL050,34084545161,24255,12499,11756,106.320176930929
SL050,34084545162,698,379,319,118.808777429467
SL050,34084545163,11021,5558,5463,101.738971261212
SL050,34084545164,193,103,90,114.444444444444
SL050,34084545165,83009,39867,43142,92.4087895786009
SL050,34084545166,1996,1014,982,103.258655804481
SL050,34084545167,1783,890,893,99.6640537513998
SL050,34084545168,84282,40242,44040,91.3760217983651
SL050,34084545169,213,110,103,106.796116504854
SL050,34084545170,225,122,103,118.446601941748
SL050,34084545171,1702,866,836,103.588516746411
SL050,34084545172,731,373,358,104.189944134078
SL050,34084545173,13278,6544,6734,97.1784971784972
SL050,34084545174,346,174,172,101.162790697674
SL050,34084545175,768,394,374,105.347593582888
SL050,34084545176,5336,2755,2581,106.741573033708
SL050,34084545177,2558,1274,1284,99.2211838006231
SL050,34084545179,586,283,303,93.3993399339934
SL050,34084545180,4218,2136,2082,102.593659942363
SL050,34084545181,2865,1490,1375,108.363636363636
SL050,34084545182,1127,572,555,103.063063063063
SL050,34084545183,3268,1716,1552,110.567010309278
SL050,34084545184,229,113,116,97.4137931034483
SL050,34084545185,9689,4823,4866,99.1163173037402
SL050,34084545186,3723,1853,1870,99.0909090909091
SL050,34084545187,4929,2454,2475,99.1515151515152
SL050,34084545188,3769,1887,1882,100.265674814028
SL050,34084545189,867,445,422,105.450236966825
SL050,34084545190,539,272,267,101.87265917603
SL050,34084545191,620,325,295,110.169491525424
SL050,34084545192,3298,1717,1581,108.602150537634
SL050,34084545193,728,375,353,106.232294617564
SL050,34084545194,73,38,35,108.571428571429
SL050,34084545195,2582,1282,1300,98.6153846153846
SL050,34084545196,1793,897,896,100.111607142857
SL050,34084545197,2496,1279,1217,105.094494658998
SL050,34084545198,2390,1227,1163,105.503009458298
SL050,34084545199,4351,2334,2017,115.716410510659
SL050,34084545200,5983,3061,2922,104.757015742642
SL050,34084545201,5164,2706,2458,110.089503661513
SL050,34084545202,5083,2621,2462,106.458164094232
SL050,34084545203,3759,1916,1843,103.960933260988
SL050,34084545204,809,419,390,107.435897435897
SL050,34084545205,10968,5618,5350,105.009345794393
SL050,34084545901,1024,534,490,108.979591836735
SL050,34104646001,1046,557,489,113.905930470348
SL050,34104646002,1393,739,654,112.996941896024
SL050,34104646003,1162,586,576,101.736111111111
SL050,34104646004,2413,1203,1210,99.4214876033058
SL050,34104646005,29341,14382,14959,96.1427902934688
SL050,34104646006,5908,2933,2975,98.5882352941177
SL050,34104646007,16270,8138,8132,100.073782587309
SL050,34104646008,3329,1669,1660,100.542168674699
SL050,34104646009,3944,1933,2011,96.1213326703133
SL050,34104646010,1202,632,570,110.877192982456
SL050,34104646011,10556,5230,5326,98.1975215921893
SL050,34104646012,1127,593,534,111.048689138577
SL050,34104646013,24222,11838,12384,95.5910852713178
SL050,34104646014,3983,1947,2036,95.6286836935167
SL050,34104646015,9908,4975,4933,100.851408878978
SL050,34104646016,1297,646,651,99.2319508448541
SL050,34104646017,44393,21685,22708,95.4949797428219
SL050,34104646018,654,350,304,115.131578947368
SL050,34104646019,11938,5850,6088,96.0906701708279
SL050,34104646020,5188,2586,2602,99.3850883935434
SL050,34104646021,31492,15691,15801,99.3038415290171
SL050,34104646022,20763,10174,10589,96.0808386061007
SL050,34104646023,440,226,214,105.607476635514
SL050,34104646024,539,267,272,98.1617647058823
SL050,34104646025,3314,1604,1710,93.8011695906433
SL050,34104646026,1532,792,740,107.027027027027
SL050,34104646027,1262,625,637,98.116169544741
SL050,34104646028,470,245,225,108.888888888889
SL050,34104646029,27285,13559,13726,98.7833309048521
SL050,34104646030,1019,510,509,100.196463654224
SL050,34104646031,13100,6634,6466,102.598206000619
SL050,34104646032,7295,3558,3737,95.2100615466952
SL050,34104646033,258,133,125,106.4
SL050,34104646034,2379,1200,1179,101.781170483461
SL050,34104646035,8932,4465,4467,99.9552272218491
SL050,34104646036,637,353,284,124.295774647887
SL050,34104646037,1418,687,731,93.9808481532148
SL050,34104646038,303,198,105,188.571428571429
SL050,34104646039,2638,1321,1317,100.303720577069
SL050,34104646040,1209,592,617,95.9481361426256
SL050,34104646041,374,211,163,129.447852760736
SL050,34104646042,4646,2327,2319,100.344976282881
SL050,34104646043,155,84,71,118.30985915493
SL050,34104646044,5276,2624,2652,98.9441930618401
SL050,34104646045,1604,822,782,105.115089514067
SL050,34104646046,1229,638,591,107.952622673435
SL050,34104646047,672,326,346,94.2196531791908
SL050,34104646048,4549,2274,2275,99.956043956044
SL050,34104646049,314,165,149,110.738255033557
SL050,34104646050,190,108,82,131.707317073171
SL050,34104646051,10878,5555,5323,104.358444486192
SL050,34104646052,594,280,314,89.171974522293
SL050,34104646053,648,327,321,101.869158878505
SL050,34104646054,14668,7128,7540,94.5358090185676
SL050,34104646055,1746,880,866,101.61662817552
SL050,34104646056,224,117,107,109.345794392523
SL050,34104646057,582,291,291,100
SL050,34104646058,2168,1084,1084,100
SL050,34104646059,1580,789,791,99.7471554993679
SL050,34104646060,11930,5918,6012,98.4364604125083
SL050,34104646061,455,234,221,105.882352941176
SL050,34104646062,5899,2986,2913,102.506007552352
SL050,34104646063,2241,1137,1104,102.989130434783
SL050,34104646064,660,346,314,110.191082802548
SL050,34104646065,1931,985,946,104.122621564482
SL050,34104646066,1576,769,807,95.2912019826518
SL050,34104646067,2224,1113,1111,100.1800180018
SL050,34104646068,418,226,192,117.708333333333
SL050,34104646069,180,88,92,95.6521739130435
SL050,34104646070,23647,11817,11830,99.8901098901099
SL050,34104646071,524,264,260,101.538461538462
SL050,34104646072,4214,2131,2083,102.304368698992
SL050,34104646073,1347,677,670,101.044776119403
SL050,34104646074,3645,1792,1853,96.708041014571
SL050,34104646075,159,85,74,114.864864864865
SL050,34104646076,715,367,348,105.459770114943
SL050,34104646077,9517,4759,4758,100.021017234132
SL050,34104646078,37584,18125,19459,93.1445603576751
SL050,34104646079,342,193,149,129.530201342282
SL050,34104646080,1195,613,582,105.3264604811
SL050,34104646081,13588,6799,6789,100.147297098247
SL050,34104646082,6575,3367,3208,104.956359102244
SL050,34104646083,20424,10107,10317,97.9645245710962
SL050,34104646084,1876,889,987,90.0709219858156
SL050,34104646085,15514,7726,7788,99.2039034411916
SL050,34104646086,93,49,44,111.363636363636
SL050,34104646087,136,73,63,115.873015873016
SL050,34104646088,172,89,83,107.228915662651
SL050,34104646089,2773,1429,1344,106.324404761905
SL050,34104646090,2275,1157,1118,103.488372093023
SL050,34104646091,145,77,68,113.235294117647
SL050,34104646092,306,160,146,109.58904109589
SL050,34104646093,2830,1416,1414,100.1414427157
SL050,34104646094,27827,13736,14091,97.4806614150876
SL050,34104646095,696,360,336,107.142857142857
SL050,34104646096,334,180,154,116.883116883117
SL050,34104646097,1125,573,552,103.804347826087
SL050,34104646098,3160,1564,1596,97.9949874686717
SL050,34104646099,818,450,368,122.282608695652
SL050,34104646100,332,170,162,104.938271604938
SL050,34104646101,992,473,519,91.1368015414258
SL050,34104646102,24536,11978,12558,95.3814301640389
SL050,34104646103,1561,746,815,91.5337423312883
SL050,34104646104,2239,1127,1112,101.348920863309
SL050,34104646105,21918,10910,11008,99.109738372093
SL050,34104646106,1498,773,725,106.620689655172
SL050,34104646107,2469,1221,1248,97.8365384615385
SL050,34104646108,494,267,227,117.621145374449
SL050,34104646109,8319,4249,4070,104.398034398034
SL050,34104646110,29108,14385,14723,97.7042722271276
SL050,34104646111,14941,7673,7268,105.572372041827
SL050,34104646112,615,325,290,112.068965517241
SL050,34104646113,3128,1554,1574,98.7293519695044
SL050,34104646114,704,362,342,105.847953216374
SL050,34104646115,355,203,152,133.552631578947
SL050,34104646116,18050,8780,9270,94.7141316073355
SL050,34104646117,692,358,334,107.185628742515
SL050,34104646118,4800,2369,2431,97.4496092143151
SL050,34104646119,903,458,445,102.921348314607
SL050,34104646120,1432,693,739,93.7753721244926
SL050,34104646121,122,61,61,100
SL050,34104646122,3547,1783,1764,101.077097505669
SL050,34104646123,2490,1269,1221,103.931203931204
SL050,34104646124,979,496,483,102.691511387164
SL050,34104646125,1030,513,517,99.2263056092843
SL050,34104646126,7342,3626,3716,97.5780409041981
SL050,34104646127,3790,1882,1908,98.6373165618449
SL050,34104646128,2038,1021,1017,100.39331366765
SL050,34104646129,682,376,306,122.875816993464
SL050,34104646130,1058,510,548,93.0656934306569
SL050,34104646131,73829,36295,37534,96.6989929130921
SL050,34104646132,2828,1427,1401,101.855817273376
SL050,34104646133,554,297,257,115.56420233463
SL050,34104646134,3276,1704,1572,108.396946564886
SL050,34104646135,13058,6334,6724,94.1998810232005
SL050,34104646136,3462,1771,1691,104.730928444707
SL050,34104646137,297,145,152,95.3947368421053
SL050,34104646138,444,232,212,109.433962264151
SL050,34104646139,5914,2904,3010,96.4784053156146
SL050,34104646140,491,257,234,109.82905982906
SL050,34104646141,508,270,238,113.445378151261
SL050,34104646142,845,433,412,105.097087378641
SL050,34104646143,5702,2880,2822,102.055279943303
SL050,34104646144,776,404,372,108.602150537634
SL050,34104646145,29045,14194,14851,95.5760554844792
SL050,34104646146,2145,1103,1042,105.854126679463
SL050,34104646147,22972,11633,11339,102.592821236441
SL050,34104646148,1984,1018,966,105.383022774327
SL050,34104646149,504,263,241,109.128630705394
SL050,34104646150,2373,1221,1152,105.989583333333
SL050,34104646151,893,466,427,109.133489461358
SL050,34104646152,118,62,56,110.714285714286
SL050,34104646153,542,271,271,100
SL050,34104646154,1049,525,524,100.190839694656
SL050,34104646155,1209,623,586,106.313993174061
SL050,34104646156,2686,1344,1342,100.149031296572
SL050,34104646157,3585,1832,1753,104.506560182544
SL050,34104646158,1240,657,583,112.692967409949
SL050,34104646159,30693,15128,15565,97.192418888532
SL050,34104646160,2439,1193,1246,95.7463884430177
SL050,34104646161,1828,959,869,110.356731875719
SL050,34104646162,1575,833,742,112.264150943396
SL050,34104646163,2480,1232,1248,98.7179487179487
SL050,34104646164,15752,7800,7952,98.0885311871227
SL050,34104646165,9538,4741,4797,98.8326037106525
SL050,34104646166,10662,5231,5431,96.3174369361075
SL050,34104646167,346,180,166,108.433734939759
SL050,34104646168,2599,1342,1257,106.762132060461
SL050,34104646169,43278,21001,22277,94.2721192261076
SL050,34104646170,4318,2161,2157,100.185442744553
SL050,34104646171,21802,10668,11134,95.8146218789294
SL050,34104646172,7583,3939,3644,108.095499451153
SL050,34104646173,1631,820,811,101.109741060419
SL050,34104646174,1180,601,579,103.799654576857
SL050,34104646175,605,301,304,99.0131578947368
SL050,34104646176,2822,1509,1313,114.927646610815
SL050,34104646177,6291,3187,3104,102.673969072165
SL050,34104646178,6205,3240,2965,109.274873524452
SL050,34104646179,2975,1500,1475,101.694915254237
SL050,34104646180,838,415,423,98.1087470449173
SL050,34104646181,25199,12380,12819,96.5753958967158
SL050,34104646182,1766,932,834,111.750599520384
SL050,34104646183,8225,4124,4101,100.5608388198
SL050,34104646184,35395,17493,17902,97.7153390682605
SL050,34104646185,446,226,220,102.727272727273
SL050,34104646186,25309,12536,12773,98.1445236044782
SL050,34104646187,1543,797,746,106.836461126005
SL050,34104646188,1047,544,503,108.151093439364
SL050,34104646189,576,292,284,102.816901408451
SL050,34104646190,69156,34254,34902,98.1433728726147
SL050,34104646191,2777,1460,1317,110.85801063022
SL050,34104646192,969,481,488,98.5655737704918
SL050,34104646193,11409,5652,5757,98.176133402814
SL050,34104646194,20709,10439,10270,101.645569620253
SL050,34104646195,2688,1359,1329,102.257336343115
SL050,34104646196,156,77,79,97.4683544303797
SL050,34104646197,2459,1237,1222,101.227495908347
SL050,34104646198,1014,513,501,102.395209580838
SL050,34104646199,7840,3940,3900,101.025641025641
SL050,34104646200,2537,1236,1301,95.0038431975403
SL050,34104646201,61,38,23,165.217391304348
SL050,34104646202,24068,12112,11956,101.304784208765
SL050,34104646203,4482,2254,2228,101.166965888689
SL050,34104646204,8566,4180,4386,95.3032375740994
SL050,34104646205,19455,9561,9894,96.6343238326258
SL050,34104646206,662,348,314,110.828025477707
SL050,34104646207,8929,4392,4537,96.8040555433106
SL050,34104646208,1358,668,690,96.8115942028985
SL050,34104646209,2370,1180,1190,99.1596638655462
SL050,34104646210,440,217,223,97.3094170403587
SL050,34104646211,2395,1170,1225,95.5102040816327
SL050,34104646212,2152,1105,1047,105.539637058262
SL050,34104646213,20227,10093,10134,99.5954213538583
SL050,34104646214,21992,11157,10835,102.971850484541
SL050,34104646215,1734,880,854,103.044496487119
SL050,34104646216,7160,3504,3656,95.8424507658643
SL050,34104646217,1114,560,554,101.083032490975
SL050,34104646218,1262,645,617,104.538087520259
SL050,34104646219,162,84,78,107.692307692308
SL050,34104646220,65669,32173,33496,96.0502746596609
SL050,34104646221,433,220,213,103.286384976526
SL050,34104646222,486,240,246,97.5609756097561
SL050,34104646223,10245,4990,5255,94.9571836346337
SL050,34104646224,158,82,76,107.894736842105
SL050,34104646225,379,190,189,100.529100529101
SL050,34104646226,35,18,17,105.882352941176
SL050,34104646227,1143,571,572,99.8251748251748
SL050,34104646228,3091,1585,1506,105.245683930943
SL050,34104646229,1171,633,538,117.657992565056
SL050,34104646230,18467,9170,9297,98.6339679466495
SL050,34104646231,3325,1657,1668,99.3405275779377
SL050,34104646232,1124,583,541,107.763401109057
SL050,34104646233,4884,2381,2503,95.1258489812225
SL050,34104646234,352,192,160,120
SL050,34104646235,27460,13531,13929,97.1426520209635
SL050,34104646236,1109,555,554,100.180505415162
SL050,34104646237,9117,4477,4640,96.4870689655172
SL050,34104646238,17158,8554,8604,99.4188749418875
SL050,34104646239,650,334,316,105.696202531646
SL050,34104646240,280,144,136,105.882352941176
SL050,34104646241,459,241,218,110.550458715596
SL050,34104646242,397,213,184,115.760869565217
SL050,34104646243,148,83,65,127.692307692308
SL050,34104646244,81245,40037,41208,97.1583187730538
SL050,34104646245,640,334,306,109.150326797386
SL050,34104646246,1254,629,625,100.64
SL050,34104646247,1132,599,533,112.382739212008
SL050,34104646248,6623,3470,3153,110.053916904535
SL050,34104646249,11540,5759,5781,99.6194430029407
SL050,34104646250,791413,376748,414665,90.8559921864638
SL050,34104646251,3036,1538,1498,102.670226969292
SL050,34104646252,126,65,61,106.55737704918
SL050,34104646253,157,85,72,118.055555555556
SL050,34104646254,1242,665,577,115.25129982669
SL050,34104646255,4303,2095,2208,94.8822463768116
SL050,34104646256,9550,4952,4598,107.698999565028
SL050,34104646257,7095,3501,3594,97.4123539232053
SL050,34104646258,3579,1815,1764,102.891156462585
SL050,34104646259,586,307,279,110.035842293907
SL050,34104646260,3380,1643,1737,94.5883707541739
SL050,34104646261,2073,1068,1005,106.268656716418
SL050,34104646262,227,120,107,112.14953271028
SL050,34104646263,365,200,165,121.212121212121
SL050,34104646902,392,184,208,88.4615384615385
SL050,34104646903,8846,4374,4472,97.8085867620751
SL050,34104646904,974,483,491,98.3706720977597
SL050,34074747001,58,36,22,163.636363636364
SL050,34074747002,23,16,7,228.571428571429
SL050,34074747003,244,142,102,139.21568627451
SL050,34074747004,1382,740,642,115.264797507788
SL050,34074747005,640,345,295,116.949152542373
SL050,34074747006,222,120,102,117.647058823529
SL050,34074747007,5455,2816,2639,106.707086017431
SL050,34074747008,21,10,11,90.9090909090909
SL050,34074747009,105,68,37,183.783783783784
SL050,34074747010,19632,9884,9748,101.395157981124
SL050,34074747011,549,306,243,125.925925925926
SL050,34074747012,108,50,58,86.2068965517241
SL050,34074747013,96,54,42,128.571428571429
SL050,34074747014,56,36,20,180
SL050,34074747015,244,134,110,121.818181818182
SL050,34074747016,68,35,33,106.060606060606
SL050,34074747017,210,115,95,121.052631578947
SL050,34074747018,39,24,15,160
SL050,34074747019,95,53,42,126.190476190476
SL050,34074747020,298,169,129,131.007751937984
SL050,34074747021,84,47,37,127.027027027027
SL050,34074747022,61,26,35,74.2857142857143
SL050,34074747023,4154,2124,2030,104.630541871921
SL050,34074747024,304,164,140,117.142857142857
SL050,34074747025,120,62,58,106.896551724138
SL050,34074747026,68,40,28,142.857142857143
SL050,34074747027,3693,1878,1815,103.471074380165
SL050,34074747028,36,20,16,125
SL050,34074747029,58,33,25,132
SL050,34074747030,1102,602,500,120.4
SL050,34074747031,228,135,93,145.161290322581
SL050,34074747032,155,90,65,138.461538461538
SL050,34074747033,228,128,100,128
SL050,34074747034,72,43,29,148.275862068966
SL050,34074747035,1024,542,482,112.448132780083
SL050,34074747036,244,137,107,128.03738317757
SL050,34074747037,174,84,90,93.3333333333333
SL050,34074747038,110,65,45,144.444444444444
SL050,34074747039,179,102,77,132.467532467532
SL050,34074747040,63,33,30,110
SL050,34074747041,161,94,67,140.298507462687
SL050,34074747042,65,42,23,182.608695652174
SL050,34074747043,309,178,131,135.87786259542
SL050,34074747044,372,198,174,113.793103448276
SL050,34074747045,861,430,431,99.7679814385151
SL050,34074747046,147,82,65,126.153846153846
SL050,34074747047,225,140,85,164.705882352941
SL050,34074747048,225,123,102,120.588235294118
SL050,34074747049,94,54,40,135
SL050,34074747050,5160,2634,2526,104.275534441805
SL050,34074747051,381,201,180,111.666666666667
SL050,34074747052,9049,4572,4477,102.121956667411
SL050,34074747053,144,71,73,97.2602739726027
SL050,34074747054,691,373,318,117.295597484277
SL050,34074747055,209,114,95,120
SL050,34074747056,100,58,42,138.095238095238
SL050,34074747057,307,176,131,134.351145038168
SL050,34074747058,226,116,110,105.454545454545
SL050,34074747059,126,79,47,168.085106382979
SL050,34074747060,257,151,106,142.452830188679
SL050,34074747061,272,145,127,114.173228346457
SL050,34074747062,173,99,74,133.783783783784
SL050,34074747063,110,57,53,107.547169811321
SL050,34074747064,34,20,14,142.857142857143
SL050,34074747065,913,487,426,114.319248826291
SL050,34074747066,1640,844,796,106.030150753769
SL050,34074747067,156,81,75,108
SL050,34074747068,35,17,18,94.4444444444444
SL050,34074747069,129,67,62,108.064516129032
SL050,34074747070,34,18,16,112.5
SL050,34074747071,524,248,276,89.8550724637681
SL050,34074747073,127,63,64,98.4375
SL050,34074747074,166,97,69,140.579710144928
SL050,34074747075,6370,3191,3179,100.377477194086
SL050,34074747076,22645,11251,11394,98.74495348429
SL050,34074747077,246,158,88,179.545454545455
SL050,34074747078,175,94,81,116.049382716049
SL050,34074747079,61,32,29,110.344827586207
SL050,34074747080,55,27,28,96.4285714285714
SL050,34074747081,48,24,24,100
SL050,34074747082,1045,536,509,105.304518664047
SL050,34074747083,107,63,44,143.181818181818
SL050,34074747084,1590,797,793,100.504413619168
SL050,34074747085,20583,9976,10607,94.0510983312907
SL050,34074747086,4716,2311,2405,96.0914760914761
SL050,34074747087,428,224,204,109.803921568627
SL050,34074747088,110,59,51,115.686274509804
SL050,34074747089,157,86,71,121.12676056338
SL050,34074747090,3252,1708,1544,110.621761658031
SL050,34074747091,78,42,36,116.666666666667
SL050,34074747092,116,69,47,146.808510638298
SL050,34074747093,884,480,404,118.811881188119
SL050,34074747094,158,89,69,128.985507246377
SL050,34074747095,41,26,15,173.333333333333
SL050,34074747096,142,74,68,108.823529411765
SL050,34074747097,366,193,173,111.560693641619
SL050,34074747098,669,340,329,103.343465045593
SL050,34074747099,159,80,79,101.26582278481
SL050,34074747100,139,78,61,127.868852459016
SL050,34074747101,2039,1043,996,104.718875502008
SL050,34074747102,294,165,129,127.906976744186
SL050,34074747103,313,173,140,123.571428571429
SL050,34074747104,3654,1797,1857,96.7689822294023
SL050,34074747105,212,115,97,118.556701030928
SL050,34074747106,57,31,26,119.230769230769
SL050,34074747109,190,100,90,111.111111111111
SL050,34074747110,484,244,240,101.666666666667
SL050,34074747111,1142,580,562,103.202846975089
SL050,34074747112,3322,1705,1617,105.442176870748
SL050,34074747113,185,103,82,125.609756097561
SL050,34074747114,5090,2540,2550,99.6078431372549
SL050,34074747115,298,170,128,132.8125
SL050,34074747116,457,251,206,121.844660194175
SL050,34074747117,330,170,160,106.25
SL050,34074747118,167,95,72,131.944444444444
SL050,34074747119,91,50,41,121.951219512195
SL050,34074747121,593,313,280,111.785714285714
SL050,34074747122,2454,1291,1163,111.006018916595
SL050,34074747123,541,302,239,126.359832635983
SL050,34074747124,496,261,235,111.063829787234
SL050,34074747125,55,31,24,129.166666666667
SL050,34074747126,48,27,21,128.571428571429
SL050,34074747127,158,88,70,125.714285714286
SL050,34074747128,61,28,33,84.8484848484848
SL050,34074747129,1019,535,484,110.537190082645
SL050,34074747130,105,54,51,105.882352941176
SL050,34074747131,182,97,85,114.117647058824
SL050,34074747132,47,27,20,135
SL050,34074747133,3764,1922,1842,104.343105320304
SL050,34074747134,161,88,73,120.547945205479
SL050,34074747135,97,56,41,136.585365853659
SL050,34074747137,32,19,13,146.153846153846
SL050,34074747138,235,132,103,128.155339805825
SL050,34074747139,1285,663,622,106.591639871383
SL050,34074747140,114,73,41,178.048780487805
SL050,34074747141,130,74,56,132.142857142857
SL050,34074747142,140,86,54,159.259259259259
SL050,34074747143,117,65,52,125
SL050,34074747144,86,48,38,126.315789473684
SL050,34074747145,671,355,316,112.341772151899
SL050,34074747146,339,178,161,110.55900621118
SL050,34074747147,113,60,53,113.207547169811
SL050,34074747148,495,263,232,113.362068965517
SL050,34074747149,51,25,26,96.1538461538462
SL050,34074747150,328,161,167,96.4071856287425
SL050,34074747151,29,15,14,107.142857142857
SL050,34074747152,91,50,41,121.951219512195
SL050,34074747153,115,60,55,109.090909090909
SL050,34074747154,158,90,68,132.352941176471
SL050,34074747155,4346,2231,2115,105.48463356974
SL050,34074747156,168,89,79,112.658227848101
SL050,34074747157,583,310,273,113.553113553114
SL050,34074747158,1094,555,539,102.968460111317
SL050,34074747159,1135,595,540,110.185185185185
SL050,34074747160,431,229,202,113.366336633663
SL050,34074747161,5242,2659,2583,102.942315137437
SL050,34074747162,55,31,24,129.166666666667
SL050,34074747163,294,142,152,93.4210526315789
SL050,34074747164,433,233,200,116.5
SL050,34074747165,8825,4477,4348,102.966881324747
SL050,34074747166,275,134,141,95.0354609929078
SL050,34074747167,247,127,120,105.833333333333
SL050,34074747168,33,21,12,175
SL050,34074747169,71,36,35,102.857142857143
SL050,34074747170,42,24,18,133.333333333333
SL050,34074747171,425,223,202,110.39603960396
SL050,34074747172,150,79,71,111.267605633803
SL050,34074747173,1089,589,500,117.8
SL050,34074747174,298,164,134,122.388059701493
SL050,34074747175,8547,4364,4183,104.327038010997
SL050,34074747176,238,122,116,105.172413793103
SL050,34074747177,102,61,41,148.780487804878
SL050,34074747178,188,104,84,123.809523809524
SL050,34074747179,471,251,220,114.090909090909
SL050,34074747180,61,32,29,110.344827586207
SL050,34074747181,197,103,94,109.574468085106
SL050,34074747182,1657,863,794,108.690176322418
SL050,34074747183,133,67,66,101.515151515152
SL050,34074747184,647,348,299,116.387959866221
SL050,34074747185,100,60,40,150
SL050,34074747186,298866,140382,158484,88.5780268039676
SL050,34074747187,94,57,37,154.054054054054
SL050,34074747188,108,59,49,120.408163265306
SL050,34074747189,162,90,72,125
SL050,34074747190,113,54,59,91.5254237288136
SL050,34074747191,108,69,39,176.923076923077
SL050,34074747192,108,63,45,140
SL050,34074747193,2038,1065,973,109.45529290853
SL050,34074747194,337,175,162,108.024691358025
SL050,34074747195,504,277,227,122.026431718062
SL050,34074747196,34,15,19,78.9473684210526
SL050,34074747197,1033,546,487,112.11498973306
SL050,34074747198,82,47,35,134.285714285714
SL050,34074747199,74,47,27,174.074074074074
SL050,34074747200,83,54,29,186.206896551724
SL050,34074747203,65,35,30,116.666666666667
SL050,34074747204,274,137,137,100
SL050,34074747205,505,274,231,118.614718614719
SL050,34074747206,82,46,36,127.777777777778
SL050,34074747207,309,180,129,139.53488372093
SL050,34074747208,67,34,33,103.030303030303
SL050,34074747209,35,23,12,191.666666666667
SL050,34074747210,458,221,237,93.2489451476793
SL050,34074747211,55,30,25,120
SL050,34074747212,400,217,183,118.579234972678
SL050,34074747213,123,62,61,101.639344262295
SL050,34074747214,1606,791,815,97.0552147239264
SL050,34074747215,53,27,26,103.846153846154
SL050,34074747216,128,75,53,141.509433962264
SL050,34074747217,2692,1392,1300,107.076923076923
SL050,34074747218,1170,610,560,108.928571428571
SL050,34074747219,58,31,27,114.814814814815
SL050,34074747220,172,90,82,109.756097560976
SL050,34074747221,107,65,42,154.761904761905
SL050,34074747222,85,46,39,117.948717948718
SL050,34074747223,167,94,73,128.767123287671
SL050,34074747224,103,55,48,114.583333333333
SL050,34074747225,83,47,36,130.555555555556
SL050,34074747226,167,96,71,135.211267605634
SL050,34074747227,60,37,23,160.869565217391
SL050,34074747228,514,273,241,113.278008298755
SL050,34074747229,239,113,126,89.6825396825397
SL050,34074747230,328,174,154,112.987012987013
SL050,34074747231,6212,3181,3031,104.948861761795
SL050,34074747232,114,63,51,123.529411764706
SL050,34164848001,7533,3771,3762,100.239234449761
SL050,34164848002,9545,4701,4844,97.0478943022296
SL050,34164848003,19140,9380,9760,96.1065573770492
SL050,34164848004,419,215,204,105.392156862745
SL050,34164848005,156,72,84,85.7142857142857
SL050,34164848006,393,193,200,96.5
SL050,34164848007,460,249,211,118.009478672986
SL050,34164848008,734,395,339,116.519174041298
SL050,34164848009,970,477,493,96.7545638945233
SL050,34164848010,567,290,277,104.693140794224
SL050,34164848011,12230,5957,6273,94.9625378606727
SL050,34164848012,2645,1339,1306,102.526799387443
SL050,34164848013,100435,48549,51886,93.568592683961
SL050,34164848014,1541,757,784,96.5561224489796
SL050,34164848015,40762,19775,20987,94.2249964263592
SL050,34164848016,7130,3495,3635,96.1485557083906
SL050,34164848017,16688,8239,8449,97.5144987572494
SL050,34164848018,1247,685,562,121.886120996441
SL050,34164848019,4678,2338,2340,99.9145299145299
SL050,34164848020,345821,162931,182890,89.0868828257423
SL050,34164848021,1637,825,812,101.600985221675
SL050,34164848022,2715,1408,1307,107.727620504973
SL050,34164848023,735,365,370,98.6486486486486
SL050,34164848024,1242,624,618,100.970873786408
SL050,34164848025,1059,544,515,105.631067961165
SL050,34164848026,1447,750,697,107.604017216643
SL050,34164848027,29636,14510,15126,95.9275419806955
SL050,34164848028,831,424,407,104.176904176904
SL050,34164848029,11304,5660,5644,100.283486888731
SL050,34164848030,772,385,387,99.4832041343669
SL050,34164848031,346,172,174,98.8505747126437
SL050,34164848032,7336,3625,3711,97.6825653462679
SL050,34164848033,239,134,105,127.619047619048
SL050,34164848034,15890,7915,7975,99.2476489028213
SL050,34164848035,545,270,275,98.1818181818182
SL050,34164848036,29288,14438,14850,97.2255892255892
SL050,34164848037,829,445,384,115.885416666667
SL050,34164848038,1375,677,698,96.9914040114613
SL050,34164848039,320,161,159,101.25786163522
SL050,34164848040,1673,834,839,99.404052443385
SL050,34164848041,840,422,418,100.956937799043
SL050,34164848042,1686,854,832,102.644230769231
SL050,34164848043,5683,2809,2874,97.7383437717467
SL050,34164848044,78276,36639,41637,87.9962533323726
SL050,34164848045,6681,3224,3457,93.2600520682673
SL050,34164848046,16972,8179,8793,93.017172751052
SL050,34164848047,212,111,101,109.90099009901
SL050,34164848048,636,328,308,106.493506493506
SL050,34164848049,725,383,342,111.988304093567
SL050,34164848050,255,155,100,155
SL050,34164848051,254,135,119,113.445378151261
SL050,34164848052,2029,981,1048,93.6068702290076
SL050,34164848053,1191,593,598,99.1638795986622
SL050,34164848054,31495,15366,16129,95.2693905387811
SL050,34164848055,3521,1760,1761,99.9432140829074
SL050,34164848056,1241,656,585,112.136752136752
SL050,34164848057,7258,3591,3667,97.9274611398964
SL050,34164848058,1158,586,572,102.447552447552
SL050,34164848059,519,271,248,109.274193548387
SL050,34164848060,4934,2508,2426,103.380049464138
SL050,34164848061,982,505,477,105.870020964361
SL050,34164848062,381,194,187,103.743315508021
SL050,34164848063,432,220,212,103.77358490566
SL050,34164848064,755,397,358,110.893854748603
SL050,34164848065,4124,2063,2061,100.097040271713
SL050,34164848066,423,225,198,113.636363636364
SL050,34164848067,1455,762,693,109.95670995671
SL050,34164848068,1835,883,952,92.7521008403361
SL050,34164848069,17554,8552,9002,95.0011108642524
SL050,34164848070,648,319,329,96.9604863221884
SL050,34164848071,7567,3731,3836,97.2627737226277
SL050,34164848072,1296,655,641,102.184087363495
SL050,34164848073,8397,4218,4179,100.933237616655
SL050,34164848074,4180,2159,2021,106.828302820386
SL050,34164848075,2651,1297,1354,95.7902511078287
SL050,34164848076,357,186,171,108.771929824561
SL050,34164848077,4363,2134,2229,95.7379991027367
SL050,34164848078,45826,21955,23871,91.9735243601022
SL050,34164848079,487,268,219,122.374429223744
SL050,34164848080,11953,5821,6132,94.928245270711
SL050,34164848081,2429,1205,1224,98.4477124183007
SL050,34164848082,45795,22039,23756,92.7723522478532
SL050,34164848083,8360,4081,4279,95.3727506426735
SL050,34164848084,27445,13309,14136,94.149688737974
SL050,34164848085,13643,6716,6927,96.9539483181753
SL050,34164848086,2569,1282,1287,99.6114996114996
SL050,34164848087,511,272,239,113.807531380753
SL050,34164848088,177,92,85,108.235294117647
SL050,34164848089,4319,2136,2183,97.8469995419148
SL050,34164848090,7684,3728,3956,94.2366026289181
SL050,34164848091,1377,696,681,102.202643171806
SL050,34164848092,1041,499,542,92.0664206642066
SL050,34164848093,1212,579,633,91.4691943127962
SL050,34164848094,4257,2082,2175,95.7241379310345
SL050,34164848095,3054,1539,1515,101.584158415842
SL050,34164848096,8379,4125,4254,96.9675599435825
SL050,34164848097,1615,799,816,97.9166666666667
SL050,34164848901,6545,3216,3329,96.6055872634425
SL050,34164848902,24222,11764,12458,94.4292823888265
SL050,34164848903,2416,1212,1204,100.664451827243
SL050,34164848904,4495,2170,2325,93.3333333333333
SL050,34164848905,3236,1584,1652,95.8837772397094
SL050,34164848906,929,458,471,97.23991507431
SL050,34164848907,444,222,222,100
SL050,34164848908,309,156,153,101.960784313725
SL050,34164848909,255,128,127,100.787401574803
SL050,34164848910,3643,1818,1825,99.6164383561644
SL050,34164848911,482,253,229,110.480349344978
SL050,34164848912,2903,1429,1474,96.9470827679783
SL050,34164848913,1492,792,700,113.142857142857
SL050,34164848914,418,202,216,93.5185185185185
SL050,34164848915,427,227,200,113.5
SL050,34074949002,60,30,30,100
SL050,34074949003,1074,547,527,103.795066413662
SL050,34074949004,123,67,56,119.642857142857
SL050,34074949005,130,75,55,136.363636363636
SL050,34074949006,145,79,66,119.69696969697
SL050,34074949007,402,208,194,107.216494845361
SL050,34074949008,462,245,217,112.903225806452
SL050,34074949009,438,226,212,106.603773584906
SL050,34074949010,405,204,201,101.492537313433
SL050,34074949011,229,127,102,124.509803921569
SL050,34074949012,76,36,40,90
SL050,34074949013,247,121,126,96.031746031746
SL050,34074949014,116,58,58,100
SL050,34074949015,232,113,119,94.9579831932773
SL050,34074949016,260,121,139,87.0503597122302
SL050,34074949017,261,131,130,100.769230769231
SL050,34074949018,317,159,158,100.632911392405
SL050,34074949019,258,137,121,113.223140495868
SL050,34074949020,281,153,128,119.53125
SL050,34074949021,18095,8752,9343,93.6744086481858
SL050,34074949022,325,172,153,112.418300653595
SL050,34074949023,1037,553,484,114.256198347107
SL050,34074949024,736,369,367,100.544959128065
SL050,34074949025,184,109,75,145.333333333333
SL050,34074949026,228,121,107,113.084112149533
SL050,34074949027,134,66,68,97.0588235294118
SL050,34074949028,108,64,44,145.454545454545
SL050,34074949029,656,341,315,108.253968253968
SL050,34074949030,85,44,41,107.317073170732
SL050,34074949031,160,85,75,113.333333333333
SL050,34074949032,305,142,163,87.1165644171779
SL050,34074949033,813,407,406,100.246305418719
SL050,34074949034,455,235,220,106.818181818182
SL050,34074949035,236,126,110,114.545454545455
SL050,34074949036,556,283,273,103.663003663004
SL050,34074949037,202,110,92,119.565217391304
SL050,34074949038,104,56,48,116.666666666667
SL050,34074949039,390,209,181,115.469613259669
SL050,34074949040,121,61,60,101.666666666667
SL050,34074949041,478,261,217,120.276497695853
SL050,34074949042,232,113,119,94.9579831932773
SL050,34074949043,303,155,148,104.72972972973
SL050,34074949044,87,48,39,123.076923076923
SL050,34074949046,275,152,123,123.577235772358
SL050,34074949047,121,68,53,128.301886792453
SL050,34074949048,116,60,56,107.142857142857
SL050,34074949050,576,306,270,113.333333333333
SL050,34074949052,194,107,87,122.988505747126
SL050,34074949053,1057,543,514,105.642023346304
SL050,34074949054,982,486,496,97.9838709677419
SL050,34074949055,106,56,50,112
SL050,34074949056,310,157,153,102.614379084967
SL050,34074949057,115,64,51,125.490196078431
SL050,34074949058,320,170,150,113.333333333333
SL050,34074949059,86,54,32,168.75
SL050,34074949061,156,87,69,126.086956521739
SL050,34074949062,110,54,56,96.4285714285714
SL050,34074949063,344,177,167,105.988023952096
SL050,34074949064,524,274,250,109.6
SL050,34074949065,1225,622,603,103.150912106136
SL050,34074949066,519,265,254,104.330708661417
SL050,34074949067,376,205,171,119.883040935673
SL050,34074949068,476,261,215,121.395348837209
SL050,34074949069,339,161,178,90.4494382022472
SL050,34074949071,761,400,361,110.803324099723
SL050,34074949075,138,74,64,115.625
SL050,34074949076,375,200,175,114.285714285714
SL050,34074949077,180,94,86,109.302325581395
SL050,34074949078,160,87,73,119.178082191781
SL050,34074949079,110,60,50,120
SL050,34074949080,702,376,326,115.337423312883
SL050,34074949081,1491,741,750,98.8
SL050,34074949082,379,192,187,102.673796791444
SL050,34074949083,51,24,27,88.8888888888889
SL050,34074949084,310,164,146,112.328767123288
SL050,34074949085,1058,536,522,102.681992337165
SL050,34074949086,112,66,46,143.478260869565
SL050,34074949087,497,271,226,119.911504424779
SL050,34074949088,96,56,40,140
SL050,34074949090,222,108,114,94.7368421052632
SL050,34074949091,280,145,135,107.407407407407
SL050,34074949092,122,59,63,93.6507936507936
SL050,34074949093,324,166,158,105.063291139241
SL050,34074949094,247,129,118,109.322033898305
SL050,34074949095,320,166,154,107.792207792208
SL050,34074949096,162,87,75,116
SL050,34074949097,80,46,34,135.294117647059
SL050,34074949098,218,120,98,122.448979591837
SL050,34074949099,98,58,40,145
SL050,34074949100,302,164,138,118.840579710145
SL050,34074949101,159,84,75,112
SL050,34074949102,195,103,92,111.95652173913
SL050,34074949103,471,247,224,110.267857142857
SL050,34074949104,316,177,139,127.338129496403
SL050,34074949105,151,79,72,109.722222222222
SL050,34074949107,131,58,73,79.4520547945205
SL050,34074949108,482,242,240,100.833333333333
SL050,34074949109,669,324,345,93.9130434782609
SL050,34074949110,358,192,166,115.66265060241
SL050,34074949111,126,66,60,110
SL050,34074949112,128,73,55,132.727272727273
SL050,34074949113,169,98,71,138.028169014085
SL050,34074949114,41,23,18,127.777777777778
SL050,34074949115,194,105,89,117.977528089888
SL050,34074949116,391,201,190,105.789473684211
SL050,34074949117,469,240,229,104.803493449782
SL050,34074949118,224,121,103,117.47572815534
SL050,34074949119,256,142,114,124.561403508772
SL050,34074949120,64,32,32,100
SL050,34074949121,409,223,186,119.89247311828
SL050,34074949122,980,504,476,105.882352941176
SL050,34074949123,603,315,288,109.375
SL050,34074949124,261,150,111,135.135135135135
SL050,34074949125,1705,871,834,104.436450839329
SL050,34074949126,274,143,131,109.160305343511
SL050,34074949127,2907,1516,1391,108.986340762042
SL050,34074949128,576,289,287,100.696864111498
SL050,34074949129,1003,532,471,112.951167728238
SL050,34074949130,176,91,85,107.058823529412
SL050,34074949131,263,137,126,108.730158730159
SL050,34074949132,352,182,170,107.058823529412
SL050,34074949133,306,161,145,111.034482758621
SL050,34074949134,179,102,77,132.467532467532
SL050,34074949135,639,328,311,105.466237942122
SL050,34074949136,342,165,177,93.2203389830509
SL050,34074949137,185,104,81,128.395061728395
SL050,34074949138,230,126,104,121.153846153846
SL050,34074949139,164,89,75,118.666666666667
SL050,34074949141,336,171,165,103.636363636364
SL050,34074949142,271,139,132,105.30303030303
SL050,34074949143,238,117,121,96.6942148760331
SL050,34074949145,232,124,108,114.814814814815
SL050,34074949146,292,145,147,98.6394557823129
SL050,34074949147,255,128,127,100.787401574803
SL050,34074949148,274,129,145,88.9655172413793
SL050,34074949149,399,199,200,99.5
SL050,34074949150,133,57,76,75
SL050,34074949151,692,364,328,110.975609756098
SL050,34074949152,540,287,253,113.438735177866
SL050,34074949153,167,86,81,106.172839506173
SL050,34074949154,123,71,52,136.538461538462
SL050,34074949155,85,45,40,112.5
SL050,34074949156,226,117,109,107.339449541284
SL050,34074949157,200,108,92,117.391304347826
SL050,34074949158,237,125,112,111.607142857143
SL050,34074949159,288,150,138,108.695652173913
SL050,34074949160,37,20,17,117.647058823529
SL050,34074949162,165,90,75,120
SL050,34074949163,207,105,102,102.941176470588
SL050,34074949164,162,80,82,97.5609756097561
SL050,34074949165,55,30,25,120
SL050,34074949166,1409,694,715,97.0629370629371
SL050,34074949167,194,108,86,125.581395348837
SL050,34074949168,105,55,50,110
SL050,34074949169,38,19,19,100
SL050,34074949170,103,54,49,110.204081632653
SL050,34074949171,668,347,321,108.09968847352
SL050,34074949172,528,275,253,108.695652173913
SL050,34074949173,385,190,195,97.4358974358974
SL050,34074949174,146,70,76,92.1052631578947
SL050,34074949175,267,138,129,106.976744186047
SL050,34074949176,684,382,302,126.490066225166
SL050,34074949177,278,145,133,109.022556390977
SL050,34074949178,923,487,436,111.697247706422
SL050,34074949179,417,226,191,118.324607329843
SL050,34074949180,156,76,80,95
SL050,34074949181,365,196,169,115.976331360947
SL050,34074949183,103,47,56,83.9285714285714
SL050,34074949184,180,99,81,122.222222222222
SL050,34074949185,185,95,90,105.555555555556
SL050,34074949186,250,122,128,95.3125
SL050,34074949187,1401,734,667,110.044977511244
SL050,34074949188,133,77,56,137.5
SL050,34074949189,219,120,99,121.212121212121
SL050,34074949190,52,28,24,116.666666666667
SL050,34074949191,286,142,144,98.6111111111111
SL050,34074949192,141,69,72,95.8333333333333
SL050,34074949193,463,240,223,107.62331838565
SL050,34074949194,347,178,169,105.325443786982
SL050,34074949197,170,86,84,102.380952380952
SL050,34074949199,262,126,136,92.6470588235294
SL050,34074949200,1075,551,524,105.152671755725
SL050,34074949201,307,154,153,100.653594771242
SL050,34074949202,184,107,77,138.961038961039
SL050,34074949203,308,160,148,108.108108108108
SL050,34074949204,55,25,30,83.3333333333333
SL050,34074949205,389,200,189,105.820105820106
SL050,34074949206,977,490,487,100.616016427105
SL050,34074949207,259,129,130,99.2307692307692
SL050,34074949208,395,209,186,112.365591397849
SL050,34074949209,520,291,229,127.07423580786
SL050,34074949210,506,254,252,100.793650793651
SL050,34074949214,762,393,369,106.50406504065
SL050,34074949216,158,93,65,143.076923076923
SL050,34074949219,8789,4302,4487,95.8769779362603
SL050,34074949220,146,78,68,114.705882352941
SL050,34074949221,277,144,133,108.270676691729
SL050,34074949222,403,205,198,103.535353535354
SL050,34074949223,872,455,417,109.112709832134
SL050,34074949224,187,92,95,96.8421052631579
SL050,34074949225,140,74,66,112.121212121212
SL050,34074949226,264,141,123,114.634146341463
SL050,34074949227,353,183,170,107.647058823529
SL050,34074949228,47,28,19,147.368421052632
SL050,34074949229,134,66,68,97.0588235294118
SL050,34074949230,89,48,41,117.073170731707
SL050,34074949231,346,166,180,92.2222222222222
SL050,34074949232,107,50,57,87.719298245614
SL050,34074949233,92,52,40,130
SL050,34074949234,429,231,198,116.666666666667
SL050,34074949235,383,195,188,103.723404255319
SL050,34074949236,89,47,42,111.904761904762
SL050,34074949237,156,82,74,110.810810810811
SL050,34074949238,205,107,98,109.183673469388
SL050,34074949239,705,362,343,105.539358600583
SL050,34074949240,205,110,95,115.789473684211
SL050,34074949241,254,140,114,122.80701754386
SL050,34074949242,483,252,231,109.090909090909
SL050,34074949243,109,56,53,105.660377358491
SL050,34074949244,48,29,19,152.631578947368
SL050,34074949245,278,137,141,97.1631205673759
SL050,34074949246,233,130,103,126.21359223301
SL050,34074949247,444,218,226,96.4601769911504
SL050,34074949248,253,123,130,94.6153846153846
SL050,34074949249,75,41,34,120.588235294118
SL050,34074949250,1519,755,764,98.8219895287958
SL050,34074949251,158,85,73,116.438356164384
SL050,34074949252,324,162,162,100
SL050,34074949255,398,211,187,112.83422459893
SL050,34074949256,280,144,136,105.882352941176
SL050,34074949257,336,168,168,100
SL050,34074949258,115,67,48,139.583333333333
SL050,34074949259,77,41,36,113.888888888889
SL050,34074949260,857,425,432,98.3796296296296
SL050,34074949261,1858,942,916,102.838427947598
SL050,34074949262,418,211,207,101.932367149758
SL050,34074949263,44,24,20,120
SL050,34074949264,579,298,281,106.049822064057
SL050,34074949265,126,65,61,106.55737704918
SL050,34074949266,75,42,33,127.272727272727
SL050,34074949267,104,58,46,126.086956521739
SL050,34074949268,404,217,187,116.042780748663
SL050,34074949269,238,111,127,87.4015748031496
SL050,34074949270,168,103,65,158.461538461538
SL050,34074949271,194,108,86,125.581395348837
SL050,34074949272,82,42,40,105
SL050,34074949273,190,97,93,104.301075268817
SL050,34074949275,61827,28759,33068,86.9692754324422
SL050,34025050001,97,58,39,148.717948717949
SL050,34025050002,165,96,69,139.130434782609
SL050,34025050003,146,81,65,124.615384615385
SL050,34025050004,631,332,299,111.036789297659
SL050,34025050005,235,128,107,119.626168224299
SL050,34025050006,1085,545,540,100.925925925926
SL050,34025050007,52,34,18,188.888888888889
SL050,34025050008,7094,3526,3568,98.8228699551569
SL050,34025050009,133,77,56,137.5
SL050,34025050010,72,41,31,132.258064516129
SL050,34025050011,132,68,64,106.25
SL050,34025050012,108,57,51,111.764705882353
SL050,34025050013,251,122,129,94.5736434108527
SL050,34025050014,144,83,61,136.065573770492
SL050,34025050015,63,36,27,133.333333333333
SL050,34025050016,49,32,17,188.235294117647
SL050,34025050017,2312,1190,1122,106.060606060606
SL050,34025050018,1441,760,681,111.600587371512
SL050,34025050019,62,33,29,113.793103448276
SL050,34025050020,1036,545,491,110.997963340122
SL050,34025050021,29,12,17,70.5882352941177
SL050,34025050022,567,289,278,103.956834532374
SL050,34025050023,252,124,128,96.875
SL050,34025050024,691,382,309,123.624595469256
SL050,34025050025,7819,3978,3841,103.566779484509
SL050,34025050026,579,288,291,98.9690721649485
SL050,34025050027,256,123,133,92.4812030075188
SL050,34025050028,95,62,33,187.878787878788
SL050,34025050029,708,383,325,117.846153846154
SL050,34025050030,213,129,84,153.571428571429
SL050,34025050031,160,99,61,162.295081967213
SL050,34025050032,309,166,143,116.083916083916
SL050,34025050033,72,45,27,166.666666666667
SL050,34025050034,1139,579,560,103.392857142857
SL050,34025050035,73,43,30,143.333333333333
SL050,34025050036,96,52,44,118.181818181818
SL050,34025050037,156,96,60,160
SL050,34025050038,1793,925,868,106.566820276498
SL050,34025050039,543,310,233,133.047210300429
SL050,34025050040,83,47,36,130.555555555556
SL050,34025050041,12,8,4,200
SL050,34025050042,17,7,10,70
SL050,34025050043,300,164,136,120.588235294118
SL050,34025050044,261,123,138,89.1304347826087
SL050,34025050045,1528,768,760,101.052631578947
SL050,34025050046,198,110,88,125
SL050,34025050047,47,33,14,235.714285714286
SL050,34025050048,33,18,15,120
SL050,34025050050,98,61,37,164.864864864865
SL050,34025050051,948,480,468,102.564102564103
SL050,34025050052,97,58,39,148.717948717949
SL050,34025050053,808,407,401,101.496259351621
SL050,34025050054,56,36,20,180
SL050,34025050055,4922,2509,2413,103.978450062163
SL050,34025050056,498,271,227,119.383259911894
SL050,34025050057,1665,847,818,103.545232273839
SL050,34025050058,63,33,30,110
SL050,34025050059,1005,527,478,110.251046025105
SL050,34025050060,217,119,98,121.428571428571
SL050,34025050061,217,111,106,104.716981132075
SL050,34025050062,2432,1233,1199,102.835696413678
SL050,34025050063,72,41,31,132.258064516129
SL050,34025050064,498,263,235,111.914893617021
SL050,34025050065,32,19,13,146.153846153846
SL050,34025050066,3891,2055,1836,111.928104575163
SL050,34025050067,20035,9865,10170,97.0009832841691
SL050,34025050068,2861,1500,1361,110.213078618663
SL050,34025050069,75,44,31,141.935483870968
SL050,34025050070,59,33,26,126.923076923077
SL050,34025050071,149,80,69,115.942028985507
SL050,34025050072,177,93,84,110.714285714286
SL050,34025050073,3276,1655,1621,102.097470697101
SL050,34025050074,9525,4918,4607,106.750596917734
SL050,34025050075,92,58,34,170.588235294118
SL050,34025050076,90,51,39,130.769230769231
SL050,34025050077,221,114,107,106.542056074766
SL050,34025050078,265,140,125,112
SL050,34025050079,271,150,121,123.96694214876
SL050,34025050080,35,22,13,169.230769230769
SL050,34025050081,592,310,282,109.929078014184
SL050,34025050082,93,51,42,121.428571428571
SL050,34025050083,112,53,59,89.8305084745763
SL050,34025050084,65,38,27,140.740740740741
SL050,34025050085,198,103,95,108.421052631579
SL050,34025050086,183,115,68,169.117647058824
SL050,34025050087,37,21,16,131.25
SL050,34025050088,367,195,172,113.372093023256
SL050,34025050089,13055,6674,6381,104.591756777934
SL050,34025050090,168,82,86,95.3488372093023
SL050,34025050091,39,20,19,105.263157894737
SL050,34025050092,508,265,243,109.053497942387
SL050,34025050093,113,62,51,121.56862745098
SL050,34025050094,1996,983,1013,97.0384995064166
SL050,34025050095,16605,8453,8152,103.692345436703
SL050,34025050096,36,19,17,111.764705882353
SL050,34025050098,189,96,93,103.225806451613
SL050,34025050099,4402,2277,2125,107.152941176471
SL050,34025050100,345,175,170,102.941176470588
SL050,34025050101,1026,512,514,99.6108949416342
SL050,34025050102,1152,619,533,116.135084427767
SL050,34025050104,386,188,198,94.9494949494949
SL050,34025050105,354,179,175,102.285714285714
SL050,34025050106,141,80,61,131.147540983607
SL050,34025050107,1240,615,625,98.4
SL050,34025050108,54,35,19,184.210526315789
SL050,34025050109,99,61,38,160.526315789474
SL050,34025050110,384,211,173,121.965317919075
SL050,34025050111,202,111,91,121.978021978022
SL050,34025050113,793,422,371,113.746630727763
SL050,34025050114,121,68,53,128.301886792453
SL050,34025050115,4543,2353,2190,107.442922374429
SL050,34025050116,229,122,107,114.018691588785
SL050,34025050117,154,86,68,126.470588235294
SL050,34025050118,2628,1324,1304,101.533742331288
SL050,34025050119,995,524,471,111.252653927813
SL050,34025050120,54,30,24,125
SL050,34025050121,306,161,145,111.034482758621
SL050,34025050122,67,40,27,148.148148148148
SL050,34025050123,597,310,287,108.01393728223
SL050,34025050124,506,274,232,118.103448275862
SL050,34025050125,404,212,192,110.416666666667
SL050,34025050126,2964,1460,1504,97.0744680851064
SL050,34025050128,31,19,12,158.333333333333
SL050,34025050129,280,147,133,110.526315789474
SL050,34025050130,436,241,195,123.589743589744
SL050,34025050131,237,128,109,117.43119266055
SL050,34025050132,1072,558,514,108.560311284047
SL050,34025050133,111,59,52,113.461538461538
SL050,34025050134,132,67,65,103.076923076923
SL050,34025050135,100,53,47,112.765957446809
SL050,34025050136,661,362,299,121.070234113712
SL050,34025050137,1162,585,577,101.386481802426
SL050,34025050138,53,31,22,140.909090909091
SL050,34025050139,342,190,152,125
SL050,34025050140,166,92,74,124.324324324324
SL050,34025050141,127,64,63,101.587301587302
SL050,34025050142,28,14,14,100
SL050,34025050143,763,440,323,136.222910216718
SL050,34025050144,35,24,11,218.181818181818
SL050,34025050146,237,129,108,119.444444444444
SL050,34025050147,945,473,472,100.21186440678
SL050,34025050148,310,168,142,118.30985915493
SL050,34025050149,34,21,13,161.538461538462
SL050,34025050150,827,423,404,104.70297029703
SL050,34025050151,701,368,333,110.510510510511
SL050,34025050152,2007,1078,929,116.038751345533
SL050,34025050153,1133,587,546,107.509157509158
SL050,34025050154,151,84,67,125.373134328358
SL050,34025050155,100,63,37,170.27027027027
SL050,34025050156,259,134,125,107.2
SL050,34025050157,323,168,155,108.387096774194
SL050,34025050159,942,461,481,95.8419958419958
SL050,34025050160,3083,1612,1471,109.585316111489
SL050,34025050161,98,55,43,127.906976744186
SL050,34025050162,181,91,90,101.111111111111
SL050,34025050163,5663,2894,2769,104.514265077645
SL050,34025050164,465,229,236,97.0338983050847
SL050,34025050165,2301,1167,1134,102.910052910053
SL050,34025050166,271,138,133,103.759398496241
SL050,34025050167,240,137,103,133.009708737864
SL050,34025050168,32,19,13,146.153846153846
SL050,34025050169,432,231,201,114.925373134328
SL050,34025050170,413,231,182,126.923076923077
SL050,34025050171,94,58,36,161.111111111111
SL050,34025050172,212,121,91,132.967032967033
SL050,34025050173,159,101,58,174.137931034483
SL050,34025050174,94,53,41,129.268292682927
SL050,34025050175,1097,537,560,95.8928571428571
SL050,34025050176,282,162,120,135
SL050,34025050177,334,178,156,114.102564102564
SL050,34025050178,362,186,176,105.681818181818
SL050,34025050179,245,132,113,116.814159292035
SL050,34025050180,130,64,66,96.969696969697
SL050,34025050181,1333,684,649,105.392912172573
SL050,34025050182,5479,2855,2624,108.803353658537
SL050,34025050183,385,209,176,118.75
SL050,34025050184,107,62,45,137.777777777778
SL050,34025050185,174,104,70,148.571428571429
SL050,34025050186,40,25,15,166.666666666667
SL050,34025050187,66,41,25,164
SL050,34025050188,29,18,11,163.636363636364
SL050,34025050189,962,521,441,118.140589569161
SL050,34025050190,850,449,401,111.970074812968
SL050,34025050191,540,269,271,99.2619926199262
SL050,34025050192,325,177,148,119.594594594595
SL050,34025050193,827,413,414,99.7584541062802
SL050,34025050194,106,64,42,152.380952380952
SL050,34025050195,59,38,21,180.952380952381
SL050,34025050196,118,62,56,110.714285714286
SL050,34025050197,104,63,41,153.658536585366
SL050,34025050198,52,33,19,173.684210526316
SL050,34025050199,395,201,194,103.60824742268
SL050,34025050200,634,333,301,110.63122923588
SL050,34025050201,601,310,291,106.529209621993
SL050,34025050202,158,83,75,110.666666666667
SL050,34025050203,1293,625,668,93.562874251497
SL050,34025050204,3509,1787,1722,103.774680603949
SL050,34025050205,90,44,46,95.6521739130435
SL050,34025050206,577,308,269,114.498141263941
SL050,34025050207,97,49,48,102.083333333333
SL050,34025050208,2373,1217,1156,105.276816608997
SL050,34025050209,3908,2009,1899,105.7925223802
SL050,34025050210,37,23,14,164.285714285714
SL050,34025050211,303,172,131,131.297709923664
SL050,34025050212,36,14,22,63.6363636363636
SL050,34025050213,101,54,47,114.893617021277
SL050,34025050214,22,15,7,214.285714285714
SL050,34025050215,21,12,9,133.333333333333
SL050,34025050216,284,152,132,115.151515151515
SL050,34025050217,574,301,273,110.25641025641
SL050,34025050218,120,74,46,160.869565217391
SL050,34025050219,6173,3162,3011,105.01494520093
SL050,34025050220,44,26,18,144.444444444444
SL050,34025050221,36,26,10,260
SL050,34025050222,1948,990,958,103.340292275574
SL050,34025050223,1081,551,530,103.962264150943
SL050,34025050224,74,45,29,155.172413793103
SL050,34025050225,2815,1486,1329,111.813393528969
SL050,34025050227,119,59,60,98.3333333333333
SL050,34025050228,325,174,151,115.23178807947
SL050,34025050229,72,37,35,105.714285714286
SL050,34025050230,1324,663,661,100.302571860817
SL050,34025050231,304,155,149,104.026845637584
SL050,34025050232,198,95,103,92.2330097087379
SL050,34025050233,112,63,49,128.571428571429
SL050,34025050234,286,161,125,128.8
SL050,34025050235,3134,1605,1529,104.970568999346
SL050,34025050236,108,63,45,140
SL050,34025050237,125,67,58,115.51724137931
SL050,34025050238,98,53,45,117.777777777778
SL050,34025050239,61,39,22,177.272727272727
SL050,34025050240,1170,589,581,101.376936316695
SL050,34025050241,691,374,317,117.981072555205
SL050,34025050242,95,58,37,156.756756756757
SL050,34025050243,370,208,162,128.395061728395
SL050,34025050244,253,136,117,116.239316239316
SL050,34025050245,88,47,41,114.634146341463
SL050,34025050246,31,20,11,181.818181818182
SL050,34025050247,1089,523,566,92.4028268551237
SL050,34025050248,588,312,276,113.04347826087
SL050,34025050249,323,187,136,137.5
SL050,34025050250,63,32,31,103.225806451613
SL050,34025050251,10509,5203,5306,98.0588013569544
SL050,34025050252,6914,3447,3467,99.4231323911162
SL050,34025050253,485,261,224,116.517857142857
SL050,34025050254,192,104,88,118.181818181818
SL050,34025050255,214,113,101,111.881188118812
SL050,34025050256,86,46,40,115
SL050,34025050257,172,97,75,129.333333333333
SL050,34025050258,61,35,26,134.615384615385
SL050,34025050259,63,35,28,125
SL050,34025050260,32,21,11,190.909090909091
SL050,34025050261,250,130,120,108.333333333333
SL050,34025050262,1446,745,701,106.276747503566
SL050,34025050263,206,118,88,134.090909090909
SL050,34025050264,180,102,78,130.769230769231
SL050,34025050265,89,53,36,147.222222222222
SL050,34025050266,120,74,46,160.869565217391
SL050,34025050267,650,307,343,89.5043731778426
SL050,34025050268,55,32,23,139.130434782609
SL050,34025050269,418,231,187,123.529411764706
SL050,34025050270,38,20,18,111.111111111111
SL050,34025050271,271,148,123,120.325203252033
SL050,34025050272,18602,9258,9344,99.0796232876712
SL050,34025050273,30,15,15,100
SL050,34025050274,64,36,28,128.571428571429
SL050,34025050275,112,69,43,160.46511627907
SL050,34025050276,142,68,74,91.8918918918919
SL050,34025050277,68,33,35,94.2857142857143
SL050,34025050278,215,114,101,112.871287128713
SL050,34025050279,90,43,47,91.4893617021277
SL050,34025050280,360,183,177,103.389830508475
SL050,34025050281,74,40,34,117.647058823529
SL050,34025050282,77,39,38,102.631578947368
SL050,34025050283,88,51,37,137.837837837838
SL050,34025050284,170,94,76,123.684210526316
SL050,34025050285,830,404,426,94.8356807511737
SL050,34025050286,99,48,51,94.1176470588235
SL050,34025050287,319,175,144,121.527777777778
SL050,34025050288,4661,2350,2311,101.687581133708
SL050,34025050289,46,24,22,109.090909090909
SL050,34025050290,463,239,224,106.696428571429
SL050,34025050291,102,56,46,121.739130434783
SL050,34025050292,274,154,120,128.333333333333
SL050,34025050293,466,246,220,111.818181818182
SL050,34025050294,68,36,32,112.5
SL050,34025050295,49,28,21,133.333333333333
SL050,34025050296,455,228,227,100.440528634361
SL050,34025050297,666880,319177,347703,91.7958717641205
SL050,34025050298,8365,4330,4035,107.31102850062
SL050,34025050901,140,87,53,164.150943396226
SL050,34025050902,86,50,36,138.888888888889
SL050,34025050903,2696,1350,1346,100.297176820208
SL050,34185151001,85144,43177,41967,102.88321776634
SL050,34195252001,86384,43765,42619,102.68894155189
